discount,discount_rate,name,original_price,price,rating_average,review_count,quantity_sold
121000,48,"Hop 6 quan lot nam thun lanh Han Quoc CITYMEN cao cap co gian 4 chieu, khang khuan, tham hut tot ( Giao mau ngau nhien )",250000,129000,4.5,13,80
0,0,"Bo quan ao the thao nam phoi mau LCT, chat vai cotton cao cap chong nhan, thoang mat, tham hut mo hoi - THE DUST",329000,329000,0,0,
0,0,COmbo 5 quan DUI May 10,125000,125000,4.5,3490,10434
0,0,Quan Ao Team Building - Du Size Nguyen Bo (DDB60),99000,99000,0,0,
180000,42,"Quan tay nam cong so cao cap AKUBA form regular, co gian nhe, chat lieu mem min ,thoang mat tham hut mo hoi tot 01T0039",429000,249000,4.5,68,203
0,0,"Do bo the thao nam mac nha hoa tiet hoat hinh, set do nam han quoc thoi trang bo nam he nang dong Cao Cap",29897,29897,0,0,
85000,25,"Combo 4 quàn lót nam Boxer sọi cạp 1cm sọi tre tụ nhien mèm mịn thám hút mò hoi, co giãn 4 chièu MRM Manlywear (3 mau)",340000,255000,4.7,543,1664
0,0,BO LAM XICH,195000,195000,0,0,
0,0,"Ao phong nam, ao thun nam co co tay ngan vai thun cotton 100% mac thoang mat - ATN04",75000,75000,5,1,4
0,0,QUAN NGU NAM COTTON HOA TIET HOA LA (HINH THAT),85000,85000,0,0,
48000,48,Combo 5 Quan lot nam nhieu lung Hieu CITYMEN,100000,52000,4.5,602,1998
0,0,Ao Giu Nhiet Nam Thun Om Body Dai Tay Lot Trong The Thao Tap Gym Da Bong,49000,49000,0,0,
0,0,Quan kaki nam TRUNG NIEN Santino chat lieu cotton cao cap dang xuong thoai mai sang trong KKG595K611,535500,535500,3.7,3,17
0,0,Ao Bomber Nam Jodan Paris Tay Da Cao Cap - Ao Khoac Nam Max Dinh Moi Nhat,699000,699000,0,0,
77000,31,Ao Khoac Kaki Nam Hai Lop Simple Cao Cap ShopN6-KK35,245000,168000,3.9,908,3246
0,0,Bo Quan Ao The Thao Nam Chat thun lanh Thong hoi thoang khi tham hut mo hoi,99000,99000,0,0,
212000,44,"Quan tay nam di hoc ong dung ton dang AKUBA form slimfit chong nhan, co gian, mem mai, ben mau 01K3008",481000,269000,4.7,23,51
0,0,Set 3 ao lot sieu nhe khong gong,80000,80000,0,0,
79200,44,"Quan Jean Nam Den Tron cao cap thuong hieu Chandi, phong cach ton dang nam tinh chat jean co dan Mau J20",178200,99000,4.6,364,942
0,0,"SET BO DO NAM CUC DEP , CHAT THUN LANH MAC SUONG , THOAI MAI CHO AE MAU MOI NHAT HIEN NAY",96030,96030,0,0,
114000,22,"Quan tay nam cong so AKUBA dang om vai min, co gian nhe, chong nhan chong xu 02E710",515000,401000,5,7,29
0,0,"Bo Quan Ao dui thoi trang Nam MENSWEAR, chat vai dui thai loai day bo do nam vai dui tre trung.",130000,130000,0,0,
56000,22,Combo 3 quàn lót nam sọi cotton Organic mèm mịn thoáng mát co giãn 4 chièu MRM Manlywear (TANG Doi Tat Nam Cao Cap mau ngau nhien),255000,199000,4.6,794,2542
0,0,"SET DO MAC NHA NAM , DO BO NAM CUC DEP HOT NHAT 2021 THOI TRANG NYNA STORE",89000,89000,0,0,
136000,31,"Ao khoac hoodie nam AKUBA form oversize, chat lieu day dan, ben mau 01C513",435000,299000,4.7,3,6
0,0,"Bo the thao nam nu thoi trang cao cap MENSWEAR, chat lieu ni do ben cao, chong nhan tuyet doi.",168000,168000,3,1,2
127500,50,"Quan Short Gio The Thao Nam 5S (QSG002S1-02) Tre Trung, Nang Dong, Nam Tinh",255000,127500,4.7,946,2696
0,0,Ao 3 lop tran bong nam dang bo xuat khau. Ao phao nam xuat khau made in Viet Nam,295000,295000,0,0,
0,0,"Ao Thun Nam Polo Ngan Tay NAIKYO TS2021 Chat Lieu 100% Polyester Nang Dong, Tre Trung, Nam Tinh ",500000,500000,4,1,6
0,0,Set Bo the thao nam ha noi thoi trang dao pho cua gioi tre - HB19,98000,98000,0,0,
0,0,Combo 5 quan lot nam hang det kim cao cap (Co tui zip) - Quan sip tam giac - WS27B,125000,125000,4.5,94,224
0,0,Set 2 bo ni da ca ke hm organic,220000,220000,0,0,
150000,50,Ao Phong Nam Polo Co Co Tay Ngan Tron Mua He Nhieu Mau VICERO,300000,150000,4.3,91,271
0,0,Bo ni nam cao cap phom xuat au anh tu chup,265000,265000,0,0,
245000,50,"Combo 4 quan dui nam the thao Sport ngan vai Thun Poly 2 Da thoang mat, chat lieu hut am, do co gian tot",490000,245000,4.5,264,613
0,0,Hot nhat thu dong,500000,500000,0,0,
126000,45,"Ao thun nam tay ngan tron AKUBA form slimfit vai min, co gian 4 chieu thoai mai van dong 01J655",279000,153000,4.8,4,41
0,0,Bo dui xanh than pha hoa - BD1,100000,100000,0,0,
185000,46,Hop 4 quan lot nam Boxer Nanjiren( quan sip dui ) hang nhap cap cap QL3,400000,215000,4.7,180,495
0,0,Bo Ni Nam Thu Dong Da Ca Cheo Sieu Mem Dep Bo Mac Ngu Nam,255000,255000,0,0,
109000,46,"Combo 10 quan lot nam CM, Thuong hieu CITYMEN, do lot nam hang Viet Nam xuat khau",238000,129000,4.5,171,535
0,0,Bo Ni Nam The Thao Thu Dong  ̀ ̀ Chat Cotton Da Ca Cao Cap In Chu Khoe Khoan Nang Dong Ma 1NiM01,539000,539000,0,0,
130000,33,"Set 2 quàn dùi nam, quàn Short Gió nam thẻ thao Basic trẻ trung nang dọng, thoáng mát co giãn 4 chièu MRM Manlywear",399000,269000,4.8,258,686
46000,26,Ao Khoac Big Size Ao Khoac Du Nam Co Co Tru Chong Nang Chong Nong Chong Lanh Chong Gio 2 Lop Phoi Logo Sot Thoi Trang Nam Tinh Han Quoc Gia Tot AD70 ,175000,129000,4.5,169,483
0,0,"Quan lot nam tam giac chat lieu mong nhe, co gian thoai mai chinh hang Santino",95000,95000,4.8,13,35
121000,35,Combo 5 quàn dùi nam Cotton mạc nhà thoải mái thoáng mát JAMANO- MÀU NGÃU NHIEN,350000,229000,4.5,162,511
0,0,"Ao khoac jeans nam in hinh cun de thuong mat cuoi , ao khoac nam form vua phoi ni mem co dan loi cuon co mu co 3 size Julido mau khoac AKJ8686 - Mau Xanh",199000,199000,4.6,853,1890
100000,40,Ao thun nam tron tay lo GENZ Premium Cotton phong Unisex form rong oversize nhieu mau - GZT01,250000,150000,5,259,644
0,0,"Ao khoac phao beo sieu nhe Santino mu chum chat lieu giu nhiet, chong tham nuoc phom dang vua van 01",685000,685000,3.7,3,7
0,0,QUAN DA ,335000,335000,0,0,
0,0,Combo 4 Quan Sip Dui Boxer  Thong Hoi Thoang Mat - Quan Lot Nam (Giao Mau Ngau Nhien),85000,85000,4.5,830,6987
0,0,Bo Thun Nam Dai Tay Mac Nha Cho Nam Kieu Dang Han Quoc Tre Trung DONASHOP99 BN120,500000,500000,0,0,
150000,50,Ao Phong Nam Polo Co Co Tay Ngan Tron Mua He Nhieu Mau VICERO,300000,150000,4.3,91,271
0,0,Bo Quan Ao Dui Nam,450000,450000,0,0,
265000,54,"Bo The Thao Nam 5S (8 mau), Chat Lieu Coolmax Sieu Mat, Dang The Thao Tre Trung, Nang Dong (BTSO21051)",494000,229000,4.8,417,1037
0,0,Phu kien bo am ta coi xay,90000,90000,0,0,
114000,22,"Quan tay nam cong so AKUBA dang om vai min, co gian nhe, chong nhan chong xu 02E710",515000,401000,5,7,29
0,0,"Set Bo The Thao, Do Bo Quan Ao Co Tron, Do Bo Thun Lanh Mac Mat - K085 ",179000,179000,0,0,
173000,51,Bo Mac Nha The Thao Nam Mua He Nang Dong ZERO,338000,165000,4.5,356,862
0,0,SET BO MU 3 MAU,125000,125000,0,0,
80000,10,Ao Khoac Nam Biluxury ( 5AG2T009) Polyester 2 Lop Can Gio Chong Nuoc Chong Bam Bui Dang Cap Mac 2 Mat Da Nang,799000,719000,4.3,6,11
0,0,Ao giu nhiet cotton co tron bigsize,150000,150000,0,0,
240000,40,Quan Tui Hop Thao Ong US ARMY U880 Chuyen Phuot Chat Vai Gio Cao Cap Mau Kho Ong Co The Thao Roi Lam Quan Short -HANG CHINH HANG,599000,359000,4.7,161,297
0,0,Ao loang tiedye dang thung unisex ma so 11,109000,109000,0,0,
0,0,"Ao POLO nam ngan tay co be Santino chat lieu the thao co dan, dang slim tre trung nang dong TSP365B858",365000,365000,0,0,
0,0,Set bo do nam Free Style du size (Mau moi 2021) Phong Cach Han Quoc Thoang Mat tre trung Nang Dong,49985,49985,0,0,
135000,45,Bo Mac Nha Nam Mua He Mat Me Cao Cap Thoi Trang ZERO,300000,165000,4.5,275,674
0,0,BO NI THU DONG NEVER STOP  BO NI DAI TAY MUA DONG SET BO NI DAI (anh that +video shop quay),99000,99000,0,0,
212000,44,"Quan tay nam di hoc ong dung ton dang AKUBA form slimfit chong nhan, co gian, mem mai, ben mau 01K3008",481000,269000,4.7,23,51
0,0,"Ao thun nam cao cap hang vnxk, ao phong nam hang xuat khau chat cotton thoang mat",249600,249600,0,0,
0,0,Ao khoac phao nam co mu dep thoi trang han quoc 3 lop vai du cao cap chong nuoc khong bam ban giu nhiet mua dong mau den mau 2019 Viet Nam xuat khau LC,189000,189000,3.5,10,27
0,0,Short V+Ao thun NamNu BIGSIZE,139000,139000,0,0,
0,0,Ao so mi nam tay ngan hoa tiet Santino chat lieu soi tre chong tia UV dang slim ta ngang sang trong ASN495S607,495000,495000,0,0,
0,0,{SIEU PHAM MUA DONG} AO KHOAC NAM/AO KHOAC NAM NI NGOAI LOT LONG GIU NHIET BAO DEP SIEU AM AP CO SIZE 3XL THOI TRANG NYN,169000,169000,0,0,
45000,50,Quan dui thun lanh mua he,90000,45000,5,22,67
0,0,Bo Dui Nam co tau ( Mat - Nhe Nhu Khong),60000,60000,0,0,
0,0,Quan kaki nam TRUNG NIEN Santino chat lieu cotton cao cap dang xuong thoai mai sang trong KKG595K611,535500,535500,3.7,3,17
0,0,Bo Ni The Thao Thoi Trang Thiet Ke Nang Dong Tre Trung Cao Cap ZERO,509000,509000,0,0,
214500,50,"Ao Thun Nam 5S Co Co (4 Mau) Chat Lieu Cotton Premium, Sieu Mat, Phom Dang Tre Trung, (APC21014)",429000,214500,4.8,249,544
0,0,Bo Mac Nha Nam Kieu Dang The Thao Phoi Mau Nang Dong Thoi Trang ZERO,600000,600000,0,0,
0,0,"Ao khoac phao nam beo sieu nhe Santino mu chum chat lieu giu nhiet, chong tham nuoc phom dang vua van 04",685000,685000,4,3,9
0,0,Bo pyjama nam sizee 45-90kg tro xuong,180400,180400,0,0,
191000,58,Quan Short Nam Kaki Vicero 6 Mau Phong Cach Han Quoc,330000,139000,4.3,645,2659
0,0,Hang Thai xin Ao lot soc ban tay co gong sieu day MS707,65000,65000,0,0,
161000,34,Ao khoac du nam AKUBA Cao cap 2 lop | 01CW011,469000,308000,4.2,5,15
0,0,set do bo nam the thao,170000,170000,0,0,
106000,49,"Combo 3 Quan sip nam thong hoi, quan lot nam chat cotton thun lanh min mat - ZQ204",215000,109000,4.3,189,767
0,0,SET BO THUN THE THAO SIEU HOT,102000,102000,0,0,
0,0,Ao so mi nam tim nhat tron dai tay Santino chat lieu soi tre dang slim sang trong ASD380M106,380000,380000,0,0,2
0,0,"Bo dui nam dai tay, chat lieu dui moc cao cap gia sieu re",229000,229000,0,0,
679000,50,"Ao Khoac Kaki Nam Cao Cap US ARMY U789, Ao Khoac Nam Kieu Linh Co Mu Lot Bong Cuu Sieu Am Phong Cach Cuc Ngau -HANG CHINH HANG",1358000,679000,5,99,123
0,0, combo 4 quan sip quan lot nam thun lanh doremon hoat hinh 4 chieu,98000,98000,5,2,9
0,0,"Ao giu nhiet nam co 3 phan phoi cau vai chinh hang Santino, chat lieu co gian thoai mai phu hop moi do tuoi TSD265P881",265000,265000,0,0,2
100000,42,"COMBO3 Quan lot nam Thong hoi nhat ban, quan sip duc thong hoi khong duong may khong vien mac thoang mat khu mui QL17",239000,139000,4.5,56,149
0,0,Ao Hoodie Ni Bong Tron  Unisex 5 mau (nam nu deu mac duoc),56000,56000,4.5,89,220
170000,50,"Set 4 Quan Lot Nam 5S (5BF020-05TG) Cap 2,5cm Chat Lieu Cotton Cao Cap",340000,170000,4.6,213,605
0,0,Quan kaki nam dai Santino chat lieu cotton cao cap dang slim tre trung sang trong KSG525K616,380000,380000,4.8,12,25
0,0,Ao nam nu dep gia re - NA47,395390,395390,0,0,
71000,47,Combo 4 Quan Lot Nam cao cap | quan xi nam | quan sip nam | lung nhat | vai thun lanh 4 chieu | hieu CM | lung lon | cap to | kieu brief | tam giac truyen thong | do lot nam,150000,79000,4.6,56,153
0,0,ao may o nam det kim dong xuan mau tim thabn,99000,99000,0,0,
21000,21,Combo 5 Quan lot nam CITYMEN - Quan sip nam tam giac Viet Nam (Nhieu Mau),100000,79000,4.3,559,4909
0,0,(FS) AO KHOAC DU NAM NU IN CHU TRUOC NGUC KD006,75000,75000,0,0,
133000,42,Quan Kaki Nam Co Gian Dang Au Thoi Trang VICERO,318000,185000,4.2,423,1145
0,0,"Ao khoac ni Hoodie ""AND THE"" Unisex Cuc chat",99000,99000,0,0,
5000,7,Quan dui nam mac ngu thun cotton 100% rat thoai mai hang chat luong loai quan thun nam dui mac ngu mau ngau nhien,69000,64000,3.5,40,274
0,0,Quan tay au nam cao cap,103000,103000,0,0,
59880,12,Ao Khoac Da Nam Lot Long Cuu Cao Cap WD007,499000,439120,4.6,59,122
0,0,"Quan short cartoon , quan short hoat hinh form unisex nam nu",79000,79000,0,0,
180000,47,Ao hoodie the thao cao cap xuat khau freesize AKUBA nam nu unisex day dan co gian ben mau khong co rut 01j0073,379000,199000,4.7,52,213
0,0,Ao So Mi Nam Ngan Tay Cong So Thoi Trang VICERO,509000,509000,0,0,
140000,35,"Ao Phong Nam Linh My (2 Mau), Chat Lieu Mem Mai, Thoang Mat, Chong Nhan, Phom Dang Xuong Tre Trung, Nang Dong (U289)-HANG CHINH HANG",399000,259000,4.8,131,240
0,0,Ao Thun Quan Trong La Than Thai - Thun Cotton ANL1003,49000,49000,0,0,
0,0,"Ao thun One Piece Zoro T01 , ao phong One Piece Zoro Unisex Nam Nu co Size be tu 25-95kg",39000,39000,4.6,101,220
0,0,QUAN GIU NHIET THE THAO NAM CAO CAP,78000,78000,0,0,
0,0,[BASIC EDITION - Ao It's You Vato9],319000,319000,5,63,84
0,0,So mi trang phoi chuot // hinh chup that,130000,130000,0,0,
190000,50,"Set 4 Quan Sip Dui Nam 5S (5BX020-05SD) Cap 2,5cm Chat Lieu CottonCao Cap",380000,190000,4.7,210,490
0,0,Bo Quan Ao Free Fire cotton co tron cuc chat - The Vo Cuc Mua 2 Hip HOP,152450,152450,0,0,
0,0,Combo 3 Quan Dui Nam,167500,167500,4.6,369,1281
0,0,AO NAM NI LEN SPORT 2 SIZE L/XL DANH CHO NAM 1111lt,30000,30000,0,0,
56000,49,Quan short nam big size quan sot nam the thao chong nong quan dui nam mac nha quan thun nam cotton 4 chieu co gian cao cap WSB2 ,115000,59000,4.5,104,490
6000,4,Ao Hoodie Ni Alan Walker Nam Nu Dang Rong G130,165000,159000,5,2,6
0,0,[SPECIAL EDITION - Ao It's Real Vato9],319000,319000,5,31,40
0,0,Quan ngo nu jean co gian tot 2 tui truoc Ms 900,286000,286000,0,0,
0,0,Ao khoac du bomber nam nu cuc bam logo chu K sac net,94000,94000,4.5,22,49
0,0,Ao So Mi Nam Den Ngan Tay Chat Cotton Co Dan Mem Mai Khong Nhan Khong Xu Dang Om Mac Thoai Mai Bao Kiem Tra Chat Luong,516000,516000,0,0,
69000,50,Ao thun tay dai nam giu nhiet cao cap vai thun cotton co gian 4 chieu mac lot ben trong am ap,138000,69000,4.8,22,82
0,0,Ao gio 3 KHOA LOT LONG Hidoli- UNISEX mac duoc ca nam va nu,169000,169000,0,0,
111200,44,"Quan jean nam chat jean xin Julido, Phoi rach mau moi form dep ton dang khong qua om mau Top09",250200,139000,4.5,214,472
0,0,Quan the thao nam nu unisex 1 Thu Dong chat day co gian ong suong mac nha mac the duc,85000,85000,0,0,
0,0,Quan Short Nam Chat Dui Chat Thoang Mat Dang Tre Trung T36,135000,135000,5,50,147
0,0,"Ao so mi lua nam nu form rong tay lo in hinh cuc hoa mi nho cuc chat, chat lua mem min, thoai mai",25777,25777,0,0,
0,0,Ao Giu Nhiet Nam Lot Ni Co 5 Phan Am Ap,79999,79999,0,0,
81000,32,Quan boxer nam cao cap vai cotton 100% thoang mat co gian 4 chieu DILANO BX01,250000,169000,0,0,
71000,24,Combo 4 quàn lót nam cạp 1cm sọi tre Bamboo tụ nhien mèm mịn thám hút mò hoi - Mau Ngau nhien,300000,229000,4.6,258,750
0,0,Quan Culottes ong rong soc mau vai Cotton min mat FFStore,150000,150000,0,0,
0,0,"Quan Lot Nam Thun Lanh Cotton ICON Co Gian 4 chieu, Quan Lot Nam Dui Boxer ICON Demin sexy cao cap - Minhstore",34000,34000,4.5,16,198
0,0,"Gap GonMoc Chum Phoi Quan Ao, Do Baby, Ta, Do Nho, Quan Lot Nam Nu 32 Kep",122500,122500,0,0,
79200,44,"Ao thun nam dai tay Julido, Chat thun cotton xin bo tay va hong mau thu dong AT1357",178200,99000,4.6,151,351
0,0,Combo 4 Quan dui nam the thao vai gio Quan Short nam mac mua he thoang mat Micado,219000,219000,3.8,27,85
40000,27,Ao Khoac Ni Bong Theu MOOS Form Rong Xe Ta Ulzzang co mu nhieu mau,150000,110000,5,13,27
0,0,Ao hoodie nam nu ni tron mat bong unisex co tron kieu han quoc,70000,70000,0,0,
21000,50,Ao Thun Nam Co Tron Nhieu Mau,42000,21000,3.4,80,432
0,0,( Ao Van Toan ) AO GATHER HOODIE,399000,399000,5,27,50
0,0, QUAN AO THE THAO NAM    BO HE CHO NAM NU IN CHU FULUA DO CAP DOI 2020,78000,78000,4.2,28,67
0,0,QUAN JEAN NAM BAGGY PHOI HAI TUI HOP UNISEX MR SMILE 99 SHOP,265000,265000,0,0,
269000,34,"Quan Tui Hop Nam Linh My US ARMY U768 Cao Cap, Chat Lieu Vai Kaki,Ben Mau, Ong Rong Phong Cach, Thiet ke Tui Hop- HANG CHINH HANG",799000,530000,5,100,142
0,0,Ao loang tiedye dang thung unisex ma so 01,95000,95000,0,0,
0,0,"Quan lot nam ARISTINO dang boxer, quan sip dui nam chat lieu Cotton Oganic mem mai, tham hut va khu mui vuot troi - ABX056",79000,79000,4.8,27,135
0,0,"Quan short quan dui nam SAT SLUX-01 vai kaki cao cap, tre trung, day dan, co gian nhe, chuan form",280000,280000,0,0,
180000,42,"Quan tay nam cong so cao cap AKUBA form regular, co gian nhe, chat lieu mem min ,thoang mat tham hut mo hoi tot 01T0039",429000,249000,4.5,68,203
0,0,"Ao Khoac Nam, Khoac Du Nam 2 lop",155000,155000,0,0,
319000,44,"Bo Quan Ao Ni Nam 5S (5 mau), Chat Lieu Cotton USA, Mem Min, Ben Mau, Khong Bai Xu, Co Gian Thoai Mai (BNI21001)",728000,409000,4.8,119,254
0,0,Bo The Thao Nam Mua He Cao Cap Chat Thun Co Gian Tham Hut Mo Hoi Tot Thuong Hieu  ̀ ̀ Ma 1CM7,289000,289000,0,0,
0,0,Ao thun nam kieu dang Han quoc - phong cach lich lam (D2),149000,149000,5,22,55
0,0,ao phao nam sieu nhe Lining fom 50-75 kg,129000,129000,0,0,
159200,44,"Quan Bo Nam cao cap thuong hieu Chandi, chat jean co dan mau moi nhat 2021 ma NT301",358200,199000,4.6,54,123
0,0,"Áo sơ mi nam, áo sơ mi nam Han Quoc kẻ karo, kiểu dáng dẹp, trẻ trung năng dộng.",207500,207500,0,0,
0,0,"Quan jean nam chat jean xin Julido, Phoi xuoc mau moi form dep ton dang khong qua om mau QJ113",134000,134000,4.3,170,419
0,0,Ao khoac BOMBER chat da unisex Hot hoa tiet N/Y 03 TM Store,115000,115000,0,0,
82000,43,"5 Quan lot nam lung Han Quoc cotton 4 chieu cao cap , lung cao,dan hoi tot, quan sip nam thuong hieu CITYMEN ( Giao mau ngau nhien )",190000,108000,4.5,56,140
0,0,Set Bo the thao nam cao cap thoi trang di choi bien - HA70,448000,448000,0,0,
10000,10,Quan dui nam cotton mac nha iBasic SHM003,99000,89000,4.7,127,456
0,0,Ao so mi nam tay ngan in hoa tiet form om dang chat lieu cotton lua thoang mat,125000,125000,0,0,
0,0,"Ao thun Nam Nu Vonesa, ao phong Unisex Nam Nu co Size tu 25-84kg B9",25000,25000,4.2,40,165
0,0,Quan Lot Nam Khang Khuan Khu Mui Tam Giac Thong Hoi Co Gan 4 Chieu Thoai Mai Van Dong QN01,130000,130000,0,0,
170000,34,Quan Tui Hop Nam Kaki Thoi Trang Phong Cach The Thao US678 Chat Vai Kaki Cao Cap Phong Cach Linh- HANG CHINH HANG,499000,329000,5,126,214
0,0,AO SO MI NAM PHOI HOA TIET THEU PHONG CACH THOI TRANG THOI THUONG,101200,101200,0,0,
0,0,Ao hoodie nam in hinh Cun de thuong - DS40,69000,69000,4.5,83,232
0,0,Ao Bomber Nam Moi Nhat - Ao Khoac Nam Chat Day Dan Cao Cap,680000,680000,0,0,
0,0,Quan jogger the thao nam tron chat gio du mem min,49000,49000,1.9,23,83
0,0,so mi lua nam ke soc body kieu dang han quoc,102000,102000,0,0,
127200,44,"Quan jean nam chat jean xin Julido, Phoi rach mau moi form dep ton dang khong qua om mau EY02",286200,159000,4.5,80,198
0,0,Ao giu nhiet lot ni mem mai co co tay dai phu hop cho mua Thu Dong Chat vai thun ni cao cap dep,150500,150500,0,0,
119000,50,COMBO 5 Ao thun tron nam form rong phong cach han quoc vai poly cotton min MAU NGAU NHIEN SIEU SALE !! SIEU SALE !!,238000,119000,3.7,33,67
0,0,Ao Gio Nam 2 Lop  ̀ ̀ Chat Lieu Gio Tron Lot Luoi Cao Cap Can Gio Can Bui Chong Nang Gon Nhe Ma 9GM,359000,359000,0,0,
0,0,Ao thun nam tay ngan co tron form tre trung vai thun mem mat free size duoi 65kg,26900,26900,3.9,43,231
0,0,"Bo Ni Nam co tron, Chat Ni Da Ca Cuc Mem, De Chiu, Thoai Mai Cho Nam",189000,189000,0,0,
0,0,"Ao thun nam nu tay lo, ao phong form rong ATL236",69000,69000,4.7,63,146
0,0,"ao cau ca, hang dep",764160,764160,0,0,
51000,32,Hop 4 Quan lot nam cao cap CITYMEN vai thun lanh,160000,109000,4.6,415,1411
0,0,Ao dai tay cotton ni hang loai 1,18000,18000,0,0,
0,0,"Ao khoac du nam , ao khac du nu , ao khoac gio , ao khoac cap doi nam nu mac vai du 2 lop",88000,88000,4.7,129,304
0,0,"Combo 2 Quan lot nam ,quan sip nam Tam giac nhat luoi thong hoi thoang khi khang khuan NO304",84000,84000,0,0,
75000,44,"ao khoac du chu Seven zia, ao khoac du chu S, ao khoac bomber chu S tay phoi, Ao khoac du nam nu mac / ao khoac gio nam nu mac / ao khoac du kieu bomber / ao khoac cap doi / ao khoac form rong unisex ullzang",170000,95000,4.5,28,82
0,0,AO SO MI NAM THEU 3D HAN QUOC(XA KHO),101000,101000,0,0,
140000,35,"Ao So Mi Nam Ngan Tay Kieu Dang Co Truong U886 Thoi Trang Han Quoc Chat Cotton Pha Lua Mem Mai, Thoang Mat, Chong Nhan, Tre Trung, Nang Dong- HANG CHINH HANG",399000,259000,5,89,135
17000,33,"Hop Quan lot nam cao cap CITYMEN vai thun lanh co mau XANH DEN, DEN, XAM NHAT, XAM DAM - (Giao Mau ngau nhien)",52000,35000,4.5,439,1877
0,0,{SIEU PHAM MUA DONG} AO KHOAC NAM /AO KHOAC NAM NI NGOAI LOT LONG GIU NHIET SIEU AM AP CHO MUA DONG CO SIZE 3XL THOI TRA,169000,169000,3.8,95,291
39000,13,Combo 3 quan dui thun nam mac nha iBasic SHM003,297000,258000,4.6,97,281
0,0,"Quan Jocker ong rong bo got in hinh Heroes co tui sau sanh dieu, quan thun ni dai ong rong nam phong cach Han Quoc",95000,95000,4.3,14,31
209000,50,Bo Quan Ao Nam 4 Mau Sang Trong Cao Cap Thoi Trang ZERO,418000,209000,4.5,76,253
0,0,Quan the thao nam jogger kaki ma TT33 tho tui hop kieu bo ong Han Quoc chat vai dep ong dai,79000,79000,1.5,2,5
0,0,"Áo khoác gió bomber nam nũ Tori local brand chát dù 2 lóp form rọng, khoác ulzzang unisex FFSTORE",125000,125000,0,0,
111200,44,"Quan jean nam cao cap chat bo sieu co dan Julido, form dung dang dep mau MM07",250200,139000,3.5,150,377
0,0,Ao khoac kaki bomber nam cao cap kieu dang han quoc,129000,129000,0,0,
60000,44,"4 Quan Lot Nam lung Han Quoc thun lanh 4 chieu cao cap, lung cao, quan sip nam thuong hieu CITYMEN ( Giao mau ngau nhien )",136000,76000,4.6,52,119
0,0,Ao khoac nam the thao Nike Dri-Fit thoi trang cao cap,205000,205000,0,0,
209000,50,Bo Quan Ao Nam Chat Ni Co Gian Thoi Trang Cao Cap ZERO,418000,209000,4.7,67,196
0,0,AO KHOAC JEAN NAM FREE SIZE NANG DONG,190000,190000,0,0,
119000,50,Quan Dui Nam Kaki 6 Mau Tre Trung Phong Cach Han Quoc VICERO ,238000,119000,4.5,460,1218
0,0,Ao Khoac Du Unisex The Future,120000,120000,0,0,
127500,50,"Combo 3 Quan Lot Nam Tam Giac 5S, Chat Cotton Premium Mem Min, Tham Hut Cuc Tot, Van Dong Thoai Mai (X3-SIP21003BRF)",255000,127500,4.6,29,99
69000,20,Ao Khoac Bomber Overco Chat Vai PCGEN Thoi Trang Nam Cao Cap,349000,280000,0,0,
0,0,"Quan jogger unisex the thao, quan ong rong kieu dang jogger mac nha nam nu vai TO ONG 3 mau nang dong",77000,77000,5,14,26
0,0,"Ao khoac phao nam nu am. nhe, day dan co mu",255000,255000,0,0,
0,0,Quan Lot Nam- Sip Lua Nam Tron Khong Duong May Mong Mat K176,64000,64000,4.5,110,507
0,0,"Sip Nam Dang Boxer, Vai Cotton Det Kim Khong Duong May Co Gian 4 Chieu NB17",20000,20000,0,0,
127200,44,"Quan bo nam co dan 4 chieu Julido Store, chat jean mem min xin xo xu huong 2021 BC2",286200,159000,4.5,124,238
0,0,Somi dan day tay thiet ke den,180000,180000,0,0,
159200,44,"Ao khoac nam Julido Store, chat jean cotton xin mau moi LD0000",358200,199000,4.6,97,183
0,0,"Bo quan ao the thao nam phoi mau LCT, chat vai cotton cao cap chong nhan, thoang mat, tham hut mo hoi - THE DUST",329000,329000,0,0,
570000,50,"Quan Kaki Nam Linh My USARMY U629 Cao Cap, Kieu Dang Quan Tui Hop Phong Cach Cuc Ngau -HANG CHINH HANG",1140000,570000,5,43,55
248886,50,Ao chong nang cho cac can thu,500286,251400,0,0,
26000,10,Combo 3 Chiec Quan Lot Nam Aristino ABF16-15,255000,229000,4.7,114,498
0,0,Ao khoac nam cuc hot,59888,59888,0,0,
119500,50,"Ao Thun Nam 5S (7 mau) Tay Ngan Premium, Chat Lieu Cotton Mem Mai, Tham Hut Mo Hoi, Co Gian Thoai Mai (TSO21023)",239000,119500,4.8,102,270
0,0,Ao khoac da nam day keo dong da xin KHONG BONG TROC hang xin cao cap nhat 2021 NYNA STORE,199000,199000,0,0,
0,0,QUAN SHORT KAKI NAM CO GIAN CAO CAP LUNG THUN BT01,39000,39000,1.8,4,18
0,0,QUAN LOT NAM - Dang Day Jocsktrap Pha Cach Nang Mong Nhe - Thun Luoi,89000,89000,0,0,
119000,50,"Combo 4 Ao Thun Nam, Co Tron, Ngan Tay, Vai Luoi Mem Min, Thun Lanh, Thong Hoi Thoang Khi, Ao Lot Nam Mac 4 Mua Sieu Mat, Co Gian 4 Chieu, Ao Tap The Thao, Tap Gym, Tham Hut Mo Hoi Cuc Tot, Phong Cach Tre Trung Nang Dong",238000,119000,3.6,25,46
0,0,Ao khoac BOMBER Nam Nu Unisex Hoa Tiet Theu 1983 Cao Cap Vai du 2 lop Khong Nhan Khong Xu Khong Ra Mau BB01,65000,65000,0,0,
126000,43,Combo 5 quan lot nam 5 mau bang lung nho - Vai thun lanh cuc mat.,295000,169000,4.8,35,130
0,0,"Ao So Mi Nam Ngan Tay, Ao So Mi Nam Dui, Nhieu Mau Phoi Chu Thoi Trang, Du Size, Chuan Hang Vnxk",129000,129000,0,0,
0,0,"Ao One Piece Luffy ATT-07, Ao thun Anime Manga One Piece Monkey D. Luffy Unisex Nam Nu",49999,49999,4.6,181,389
0,0,Combo 4 Quan Lot Nam Xuat Nhat - Quan Sip Nam Thong Hoi Cao Cap - Chat Lieu Mem Min Mat Lanh,105000,105000,4.3,18,65
159200,44,"Quan Bo Nam cao cap thuong hieu Chandi, chat jean co dan mau moi nhat 2021 ma HD26",358200,199000,4.6,75,172
95000,50,"Ao khoac Cardigan Unisex Nam Nu Theu gau - Chat Ni Bong Ngoai Mem Min Bomber Cardigan, ao cardigan phoi vien, ao cardigan phoi 2 tui dep, ao khoac cardigan chong nang, mac am mau thu dong de phoi do",190000,95000,0,0,
105000,54,Quan shorts the thao nam dang sot sport dui chat thun lanh 4 chieu cao cap phu hop tap gym hay mac nha co mau trang va den DUI-P101,194000,89000,4.5,189,868
0,0,Ao Lien Quan MB Quilen Thong Soai,89000,89000,0,0,
127200,44,"Quan Jean Nam co dan 4 chieu Julido, dang Skinny ong con mau moi 2021 WW002",286200,159000,4.5,68,143
0,0,"Quan Dai Nam ZERO,Chat Lieu Gia Bo Tre Trung",469000,469000,0,0,
0,0,"AO KHOAC DU NAM FORM RONG 2 LOP PHOI MAU DI MUA,CAN GIO, CHONG NANG DA NANG TA3979 THOI TRANG MOI KINGSHOP79",67000,67000,3.7,59,214
0,0,Ao Heavy - Ao Khoac Free Fire Hoodie Ni Team Heavy,199000,199000,0,0,
0,0,"Quan dui nam Guzado phong cach the thao khoe khoan, chat gio mem sieu min, co gian tot, van dong thoai mai GSR01",85000,85000,4.6,53,157
0,0,Quan Jogger Ni Nam Thoi Trang Thu Dong,39000,39000,0,0,6
0,0,"Ao One Piece Zoro ATT-04, Ao thun Anime Manga One Piece Roronoa Zoro Unisex Nam Nu",49000,49000,4.5,50,127
40000,58,Ao thun nam tron co tron thoi trang Everest nhieu mau,69000,29000,4.5,549,1839
0,0,"Quan Lot Nam Cao Cap BLAZEL BLZ207 - Sip Nam Cotton Thong Thoang, Khang Khuan, Kieu Dang Thoi Trang",35000,35000,4.8,253,579
79200,44,"Ao thun nam the thao tay lo, co tron dep, tre trung, mac thoang mat, tham hut tot CHANDI HH11",178200,99000,4.5,38,108
49500,33,"Quan Lot Nam soi thun lanh thong hoi khang khuan, Quan Sip Nam co gian 4 chieu tham hut mo hoi cuc tot thuong hieu BAW (combo 3 mau ngau nhien) NT7987",148500,99000,4.3,37,120
0,0,Quan lot hoat hinh de thuong phong cach Han Quoc chat cotton thoang khi QLR06,18900,18900,0,0,
0,0,"Ao khoac nam cach nhiet GOKING co tui trong va 2 tui ngoai day keo, vai du am ap, can gio hieu qua",235000,235000,4.5,739,2599
0,0,AO KHOAC JEAN NAM NU CO NON UNISEX MR SMILE 99 SHOP,250000,250000,0,0,
65000,50,(ANH THAT) Ao thun nam nu fom rong Unisex in hinh Rong den trang vai thun mem min thoang mat tham hut mo hoi AT859B883D,130000,65000,5,15,81
0,0,"Quan Jeans Nam Xanh than, Vai Co Dan, Mac Thoai Mai, Khong Phai, Form dep",299000,299000,0,0,
189500,50,"Ao Thun Nam Co Co Ngan Tay 5S (4 Mau), Chat Lieu 100%Coolmax Mem Min, Sieu Tham Hut Mo Hoi, Thoang Mat (APC21008).",379000,189500,4.7,67,200
0,0,HOP 4 QUAN SIP DUI THONG HOI MEN'S CAO CAP,125000,125000,0,0,
0,0,AO KHOAC NAM UNISEX NAM- NU CO DUNG 7ZIA CHAT LIEU DU 2 LOP DI MUA CAN GIO CHONG NANG TOT HOT TREND 2021,97000,97000,5,10,24
0,0,"1 Sip Tam Giac Nam chat cotton lo kho thoang,vai nhe em, thoai mai",30000,30000,0,0,
160000,42,"Ao Ni Nam Co Tron 5S (5 mau), Chat Lieu Cotton USA Mem Min, Khong Bai Xu, Thiet Ke In Hoa Tiet Tre Trung (ANI21007)",379000,219000,4.5,53,107
0,0,Quan dui Han Quoc chat mat lanh,65000,65000,0,0,
150000,50,Ao Phong Nam Polo Co Co Tay Ngan Tron Mua He Nhieu Mau VICERO,300000,150000,4.3,91,271
0,0,Quan lot Nam Nu Unisex size M-L-XL XXL,9800,9800,0,0,
0,0,"Ao khoac nam GOKING mu dau hien dai, 1 tui trong 2 tui ngoai, ao khoac gio 2 lop, vai du cao cap chong nuoc, di mua, can gio tot, giu am hieu qua",255000,255000,4.7,244,501
0,0,Ao so mi nam oversize phoi 2 mau chat kaki han day dan form 50-70kg mac,278000,278000,0,0,
170000,50,"Set 4 Quan Sip Dui Nam 5S (5BX020-01) Chat Lieu Cotton Cao Cap, Mem Min Thoang Mat",340000,170000,4.5,125,317
0,0,Quan Ngo BIG SIZE- LUNG CAO - PHOM EO TO - Rach khong co gian,215000,215000,0,0,
0,0,"Ao Thun Nam Phan Quang Alan Walker, Ao Uninsex, Size Rong,  Size Lon, Size Nho, Tay Ngan, Co Tron, Ao Nam Size Lon, Co Ao Thun Size 2XL, 3XL, 4XL, XXL, XXXL, XXXXL",59000,59000,4.5,73,156
0,0,GIYO Winter Warm Gloves Thicken Cycling Gloves Men Women Touchscreen Gloves Non-Slip Shock Absorption for Cycling Riding Running Hiking,622556,622556,0,0,
0,0,"Quan bo, jean baggy nam, xanh + den, ong suong rong TR01, Style han quoc",132000,132000,5,2,4
0,0,Ao khoac kaki nam nu phoi tui hop co mu cuc cool ngau,135000,135000,0,0,
0,0,{SIEU PHAM MUA DONG} AO KHOAC NAM/AO KHOAC NAM NI NGOAI LOT LONG GIU NHIET BAO DEP SIEU AM AP CO SIZE 3XL,69000,69000,0,0,
0,0,AO SO MI NAM LUA TRON KHONG NHAN FROM BODY CHUAN,104300,104300,0,0,
179000,60,Ao Phong Nam Polo Co Co Tay Ngan Tron Cao Cap Phong cach Han ZERO,298000,119000,4.5,72,205
368755,50,"ao cau ca, hang dep",741235,372480,0,0,
420000,47,"Ao Khoac Phao Nam 5S (4 Mau) Chan Bong Cao Cap, Sieu Nhe, Sieu Am, Phom Om Tre Trung, Mau Sac Co Ban De Phoi Do (AKC21016)",889000,469000,4.5,53,94
0,0,"Ao Khoac Da Lon Nam Lot Long Cao Cap Lados 160 - Thiet ke don gian, thoai mai, phu hop voi moi lua tuoi",649000,649000,0,0,
3000,4,"Quan jogger unisex the thao, quan ong rong kieu dang jogger mac nha nam nu vai TO ONG 3 mau nang dong",83000,80000,4.7,15,25
131000,40,"Combo 3 quan sip dui nam, set 3 quan lot boxer nam Aristino chat lieu cotton khang khuan, khu mui, co gian 4 chieu tham hut mo hoi cuc tot ABX03707",330000,199000,4.8,24,60
127200,44,"Quan bo nam co dan 4 chieu Julido Store, chat jean mem min xin xo xu huong 2021 BC1 - 31",286200,159000,0,0,78
0,0,Quan Short Thun Nam Kenta Den QST0001,160000,160000,0,0,
0,0,"COMBO 4 QUAN LOT BOXER NAM cao cap chat vai mem min, hut mo hoi tot, kieu dang quyen ru L2893",98900,98900,4.3,13,61
0,0,SET BO NAM,110000,110000,0,0,
127200,44,"Quan Jean Nam mau xanh thuong hieu Julido Store, mau moi phoi rach QJ125",286200,159000,4.6,71,152
0,0,AO KHOAC DU BOMBER NU SIEU DEP ,96030,96030,0,0,
0,0,Quan Lot Nam Boxer SUKIYA Hop 3 mau Chat thun lanh khang khuan Hang xuat Nhat Ban cao cap QL01,119000,119000,4.7,29,93
0,0,QUAN LOT NAM 5D HANG DEP CHAT SIEU MIN CO GIAN,35000,35000,0,0,
150000,38,"Hop 5 quan boxer, sip dui nam khong duong may chat lieu thun lanh min mat",400000,250000,4.5,20,56
0,0,ao khoac kaki jeans Khoa anh that unisex,398000,398000,0,0,
0,0, Ao thun tay lo cotton Gau Rong  (ao thun tay lo unisex nam nu deu mac duoc0,39000,39000,3.9,51,284
0,0,Ao Khoac nam Da Lon Lot long Cao Cap Nhieu Mau Nhieu Size,328000,328000,5,1,2
39000,50,"Ao thun tay lo,ao thun unisex nam from rong B6",78000,39000,3.2,23,40
125000,50,Ao thun nam  co tron GUMAC ATNB619,250000,125000,4.7,30,113
0,0,"(Hang Cao Cap) Ao Gio Pmax, 1 Lop, Vai Xin co dan, Mac Cho Ca Nam Nu, Chong Nuoc, Chong Gio, Chong Nang, Phom Tre Trung",239000,239000,4.5,67,140
0,0,Combo 3 Quan Lot Nam JME JM039 (Free Size),179000,179000,5,12,80
0,0,AO SO MI NAM HOA TIET THEU CAO CAP CHAY NHAT THI TRUONG,88000,88000,2,2,3
138000,60,Ao polo nam co tau GUMAC tay phoi vien lich lam ATNB462,230000,92000,4.8,22,55
4000,2,Hop 4 quan lot nam Boxer Nanjiren ( quan sip dui ) hang nhap cap cap QL4,199000,195000,4.5,49,133
0,0,Quan Short kaki Nam Q23,35000,35000,0,0,
0,0,Hop 3 quan sip nam boxer 5D cao cap ,45985,45985,0,0,5
0,0,KHOAC PHAO TUI HOP,430000,430000,0,0,
121000,40,"Quan Boxer Nam soi thun lanh khang khuan, Quan Lot Nam co gian 4 chieu tham hut mo hoi cuc tot thuong hieu BAW (combo 3 mau ngau nhien) NH79",300000,179000,4.6,16,43
0,0,Ao Bomber LV Nam Cuc Chat - Ao Bomber Nam Moi Nhat,695000,695000,0,0,
190000,35,Ao So Mi Nam Cong So Sang Trong AKUBA | 02A917,549000,359000,4.6,39,93
0,0,Cay lon vai cay lon co loai ngan co can mau den,8400,8400,0,0,
127200,44,"Quan bo nam co dan 4 chieu Julido Store, chat jean mem min xin xo xu huong 2021 BC1 - 32",286200,159000,0,0,357
0,0,{SIEU PHAM MUA DONG} AO KHOAC NAM/AO KHOAC NAM NI NGOAI LOT LONG GIU NHIET BAO DEP SIEU AM AP CO SIZE 3XL,69000,69000,0,0,
0,0,"Quan jean baggy Vonesa nam nu ong rong , dang xuong , khong phai mau Q2",125000,125000,4.6,14,38
0,0,"Ao khoac da nam bomber xin xo cao cap cho cac ban cool ngau , bao banh KB FASHION",179000,179000,0,0,
147000,30,Combo 5 quan sip Boxer cotton co gian thoai mai thuong hieu Coolmate,496000,349000,4.8,11,48
0,0,Quan dui nam Essen - Quan dui Thom - Quan dui Mikenco - Quan Dui nam dep ️,479000,479000,0,0,
10000,6,Ao Khoac Bomber Unisex Nam Nu Da Lon Tay Phoi Da In Chu Cuc Bam G128,175000,165000,4.7,7,17
0,0,combo 03 Quan dui nam soc caro chat vai cotton mem tham hut tot size 50kg - 70kg,120000,120000,0,0,
142500,50,"Combo 3 Quan Sip Nam Boxer 5S, Cap To, Chat Cotton Cao Cap, Tham Hut, Co Gian, Khang Khuan Tot (X3-SIP21001BOX).",285000,142500,4.8,12,33
0,0,Ao khoac Kaki Nam,175000,175000,0,0,
0,0,Quan dui nam mac nha vai cotton mat form rong rai in hinh cay dua size duoi 75kg,20000,20000,3.4,21,171
0,0,Quan Giu Nhiet Nam - Quan combat pro lot long cao cap,99000,99000,0,0,
0,0,"AO KHOAC DU , AO KHOAC DU NAM CUC CHAT , CO MU CHE NANG SIEU DEP NGAU NHAT 2021 THOI TRANG 1HITSTORE1",79000,79000,3.8,42,114
0,0,Combo 5 Quan lot nam thong hoi co gian,155000,155000,0,0,
0,0,Ao thun nam nu Vonesa Hero Team full nhan vat sieu dep ca tinh du size 25-84 kg,24000,24000,5,8,11
0,0,Quan kaki nam nu ong xuong sanh dieu tre trung nang dong,94000,94000,0,0,
0,0,Do bo nam pijama soc ke vai chat vai cotton 100%,126000,126000,4.1,32,141
0,0,"ao cau ca, hang dep",764160,764160,0,0,
168000,60,"Ao thun nam tui phoi khoa GUMAC nhieu mau tre trung, lich lam ATNB475",280000,112000,4.7,33,100
0,0,hop 4 quan sip quan lot nam cao cap dui,75000,75000,0,0,
245000,50,"Combo 4 quan dui nam the thao Sport ngan vai Thun Poly 2 Da thoang mat, chat lieu hut am, do co gian tot",490000,245000,4.6,28,78
0,0,Ao khoac da nam lot long cao cap sanh dieu the hien dang cap quy ong - AD14,299000,299000,0,0,
0,0,Bo Quan Ao Nam Nu The Thao Unisex Quan Short Ao Thun Hoa Tiet Gau Truc In Chu PANDA Ulzzang Zenkonu QA NAM 1000092V1,69000,69000,3.9,21,51
0,0,Ao khoac Bomber ni cao cap,170000,170000,0,0,
297000,50,Quan jean nam GUMAC QJNB785 xuoc,595000,298000,5,23,56
0,0,Sịp cạp to khoẻ khoắn Vải cotton co giãn 4 chiều - là loại vải thoáng mát và thấm hút mồ hôi,120000,120000,0,0,
30000,19,Ao Len Co Lo Nam SZone SAL222 Phong Cach Han Quoc,159000,129000,4.5,122,317
0,0,Quan lot nam cotton ES Collection thoi trang,48000,48000,0,0,
20000,14,Ao Ni Nam Nu Hoodie Unisex Califfo 2 Mau duoi 70kg - Dang Rong Kem Mu Tui Truoc G080 - Zeni69 Store,139000,119000,4.6,11,24
0,0,Ao Bomber Bong Chay chat ni bong cao Cap Unisex Ao khoac hoodie thu dong,92000,92000,0,0,
20000,7,Quan nam Jogger Sweatpants thuong hieu Coolmate,299000,279000,4.8,29,105
0,0,Ao khoac bomber du unisex form rong 2 lop 28 nam nu ulzzang Wind sieu xinh.,226850,226850,0,0,
179500,45,"(MAC NHU KHONG MAC) Combo 4 mau_ Ao thun Nam dang luoi co gian 4 chieu, Ao phong Nam_Ao ba lo tap the thao",399000,219500,4.8,23,50
0,0,"Ao Khoac Du kieu Bomber, Ao khoac Unisex 2 Lop Chong Nang Sieu HOT - K078_PY ",139000,139000,0,0,
180000,50,"Set 4 Quan Sip Dui Nam 5S (5BX020-02) Chat Lieu Bamboo Cao Cap, Mem Min Thoang Mat",360000,180000,4.5,107,253
0,0,"aO Khoac Du Bomber Nam Nu ZZA Unisex 2 lop du Size, Ao khoac du in logo TMS bao dep, Ao khoac bomber du unisex 2 lop,Ao khoac du TMS LOGO JACKET, ao khoac du gio the thao unisex ulzzang from rong phong cach han quoc",101000,101000,4.5,17,29
40000,16,"Combo 2 ao ba lo nam/ao 3 lo nam, soi cotton mem min sieu thoang mat, tham hut mo hoi cuc tot, co gian 4 chieu MRM FASHION -MM",250000,210000,4.6,213,726
421000,50,"Ao khoac gio nam chinh hang Aristino KJK002W9 mu thao roi tien loi, chat lieu polyester chong nuoc, khong nhan nhau. Ao jacket nam Benzmen",850000,429000,4.8,21,55
0,0,"Set 5 Quan Lot Dui, Tam Giac Munafie Cho Nam Cao Cap Kem Tui Zip",84999,84999,4.5,22,43
0,0,Quan nam Vai Kaki phong cach jogger thoang mat cao cap-QB057,49000,49000,1,4,10
0,0,Combo 3 Chiec Quan Lot Tam Giac Nam Thoi Trang Aristino ABF 16 05,255000,255000,4.7,22,124
0,0,"Ao khoac nam, nu_Manchester united_ADIDAS",455000,455000,0,0,
72000,19,Combo 3 Quan Lot Nam Aristino ABX01807,375000,303000,4.7,57,200
0,0,FOG PANTS - Quan FOG Essentials Track Reflective (Iridescent) ,1350000,1350000,0,0,
300000,30,Ao Khoac Nam Linh Kaki Lot Long Cuu Dang Dai Co Mu,999000,699000,4.6,59,93
0,0,"Quan short jean den trang cap cao ton dang, vai co gian 4 chieu",258000,258000,0,0,
108000,44,"Ao khoac nam JJ05 DO , khoac du nam 2 lop phoi non khong thao roi thoi trang han quoc tre trung cuon hut Julido mau TT02 chat lieu tham hut mo hoi day dan mac thoang mat",243000,135000,3.9,164,426
0,0,Quan jean nam theu chu ban to phoi xuoc phong cach han quoc cuc xin xo,152000,152000,0,0,
0,0,{SIEU PHAM MUA DONG} AO KHOAC NAM /AO KHOAC NAM NI NGOAI LOT LONG GIU NHIET SIEU AM AP CHO MUA DONG CO SIZE 3XL KEN BLOCK,169000,169000,4.2,22,51
0,0,Ao “TVD PINE BLING BLING FLANNEL | CROPPED”,299000,299000,0,0,
159200,44,"Quan Bo Nam cao cap thuong hieu Chandi, chat jean co dan mau moi nhat 2021 MA195",358200,199000,4.6,69,200
0,0,"Quan Dui Nam Vai Lua Mem, Sieu Nhe, Dang The Thao, Thiet Ke Tre Trung Nang Dong mac o nha-tsstore95",59400,59400,0,0,
0,0,Ao khoac kaki nam 2 lop thoi trang SITAKI cao cap AKK18,175000,175000,3.6,74,209
0,0,"ao khoac nam cao cap, ao khoac du hang vnxk",320000,320000,0,0,
0,0,Ao Khoac Du Nam Phoi Day Keo - K2015,120000,120000,3.9,100,466
0,0,Ao Khoac Ni Co Non KENTA Den AKN0175,245000,245000,0,0,
159200,44,"Quan Jean Nam cao cap co dan 4 chieu Thuong Hieu Chandi, phong cach han quoc tre trung ca tinh MR9011",358200,199000,4.7,58,112
0,0,QUAN SHORTS KAKI PHONG CACH TRE TRUNG SPORTMAN - Q36,49000,49000,0,0,
0,0, quan nam dài chat dui mem mai,49000,49000,1,2,11
0,0,"Ao So Mi Nam Dep Kieu Dang Han Quoc, Vai Nen Chong Nhan Tham Hut Mo Hoi",249500,249500,0,0,
46000,15,Combo 3 Chiec Quan Lot Nam Cao Cap Aristino ABF01807 Chat lieu Cotton Chitosan Thuan Khiet (Giao Mau Ngau Nhien) - Hang Chinh Hang,315000,269000,4.7,46,115
0,0,Ao Mang To - Ao Da Nam Cao Cap Da Nang - Tran,2500000,2500000,0,0,
0,0,"Quan Boi Nam Thiet Ke Vay Ca Map Cleacco Chong Tham Nuoc , Nhanh Kho Tang Kem Non Boi va Bit Tai Silicon Cao Cap",149000,149000,4.8,52,236
71000,28,"Quan short ni nam cao cap, chat vai da ca mem min unisex DILANO SN01",250000,179000,0,0,
79500,45,"Quan Lot nam thong hoi, Quan Boxer nam vai thun lua bang co gian thoang mat thuong hieu BAW (Combo 5 quan mau ngau nhien) NT7979",178500,99000,4.6,35,70
0,0,AO KHOAC CARDIGAN NAM NU THIET KE HOA TIET SIEU NGAU NYNA STORE,97000,97000,0,0,
121000,48,"Hop 6 quan lot nam thun lanh Han Quoc CITYMEN cao cap co gian 4 chieu, khang khuan, tham hut tot ( Giao mau ngau nhien )",250000,129000,4.5,13,80
0,0,"Quan Kaki Nam Cao Cap, Dang Au Vicero Phong Cach Cong So, LICH LAM, SANG TRONG",306000,306000,0,0,
0,0,AO KHOAC DU BOMBER UNISEX NAM CHAT,100000,100000,4.1,11,42
0,0,"Ao khoac gio nam co mu 2 lop chong nuoc,che nang, mua, mu giau duoc vao co ao",168000,168000,0,0,
209000,50,Bo Ni Nam The Thao Thuong Hieu Thoi Trang VICERO,418000,209000,4.5,137,340
0,0,Quan Shorts Kaki nam KIEU DANG MAT ME TRE TRUNG,106000,106000,0,0,
135000,45,Bo Mac Nha The Thao Nam Chat Lieu Cao Cap Mua He 4 Mau ZERO,300000,165000,4.7,123,262
0,0,Quan Jogger Ni Chat Min Am Thoi Trang ZERO,460000,460000,0,0,
159000,50,Ao polo nam ADINO mau hong phoi vien chim vai cotton co gian dang slimfit tre trung nang dong AP85,318000,159000,5,9,12
0,0,Ao ni Louisvuiton 3 mau sieu hot- Ao Ni Nam Moi Nhat,505000,505000,0,0,
0,0,"[COMBO 4] Quan short nam chay bo, quan dui the thao nam co day rut cao cap phong cach Han Quoc vai me co gian",139000,139000,1.3,3,7
60000,30,Quan Boxer Nam Soc Ke Brave B1155,199000,139000,0,0,
0,0,Combo 3 quan dui nam mac nha vai thun mat loai quan dui 3 soc danh cho nguoi duoi 70kg,79000,79000,4.5,7,28
0,0,(SALE) BO CHU COTTON TAU QUAN KE,85000,85000,0,0,
0,0,Quan Baggy Kaki Nam Tron ong con unisex phoi do thoai mai,83000,83000,0,0,
0,0,QUAN JEANS RACH MA SANG A,168000,168000,0,0,
67000,35,Ao Khoac Nam Ao Khoac Du Nam Nu Hai Lop Chong Nuoc Chong Nang Chong Gio Phoi Non Cao Cap QD54 - ShopN6 (Nhieu Mau),189000,122000,4.6,113,254
0,0,Quan Jogger the thao Quan tap gym nam 3 soc dai Q-01,54900,54900,4.5,35,158
66000,16,"Combo 3 Chiec Quan Lot Nam Aristino Cao Cap AD 09, Chat Lieu Soi Tre, Khang Khuan, An Toan - Hang Chinh Hang",405000,339000,4.5,72,340
127200,44,"Quan jeans nam cao cap nhieu mau Julido, chat jean co dan 4 chieu mau HUY01",286200,159000,4.5,54,93
0,0,"Ao thun nam nu tay lo, ao phong form rong ATL233 - Yinxx",53000,53000,4.6,18,41
159200,44,"Quan Jean Nam dep dan dau xu huong Thuong Hieu Chandi , mau moi form dep ton dang khong qua om MR9043",358200,199000,4.7,64,142
116000,45,"Ao Thun Nam Ngan Tay Co Tron (5APKT001) Chat Lieu Thun Lanh Cotton Cao Cap Tre Trung, Thoang Mat Chinh Hang BiLuxury",255000,139000,4.6,21,49
0,0,Ao khoac gio ,1000000,1000000,0,0,
0,0,Ao giu nhiet nam co lop lot ni dai tay,69000,69000,0,0,3
0,0,Quan lot nam quan sip nam tam giac cap cao vai cotton co dan 8 chieu,11000,11000,0,0,3
100000,35,Ao thun nam co tron cao cap ngan tay dep chat vai cotton co gian 4 chieu thoang mat ZAVAS  Z13,289000,189000,4.8,44,114
0,0,"Quan Sip Dui Nam, Quan Con Dui Nam Vai Thun Cotton Thoang Mat Freesize Duoi 59kg Chong Khu Mui",19000,19000,0,0,
24000,56,"Quan lot nam lung Han Quoc thun lanh 4 chieu cao cap, lung cao, quan sip nam CITYMEN",43000,19000,4.8,76,563
0,0,Ao Khoac Ni Gau Trang Cute Xinh Xan Vai Day Dan Phong Cach Han Quoc Co Anh That SP000426,95000,95000,0,0,
0,0,"[SALE SOC] Ao khoac blazer nam ,ao vest nam balzer nam phong cach Han Quoc - DUKI STORE",813800,813800,0,0,
0,0,Ao phong nam WIND ban Premium cotton tay lo unisex form rong Squid Game nam nu oversize,159000,159000,0,0,
0,0,Ao giu nhiet nam dai tay cao cap dang body dep,40000,40000,1.8,5,17
0,0,Ao 3 lop tran long vu nam xuat khau. Ao long vu phao nam xuat khau made in Viet Nam.,585000,585000,0,0,
105000,70,Quan short du gio HAHAMAN the thao co gian cao cap QD0025,150000,45000,4.6,34,105
0,0,Chai xit Nam Viga 50000 (hot),255000,255000,0,0,
75000,44,"ao khoac du bomber dau lau hot trend, AO KHOAC DU BOMBER CUC HOT, ao khoac bong chay han quoc, ao khoac bomber chu K, ao bomber jacket kill system, ao khoac du dep, ao bomber unisex from rong phong cach ullzang",170000,95000,4.1,10,29
0,0,Ao khoac kaki nam nu kieu form rong cuc dep phong cach cho cac ban tre NYNA STORE,109000,109000,0,0,
0,0,DEP XUAT SAC Bo Do Ngu Dai Tay Chat Kate Bo Pijama Lua Dai Tay Phu Hop Ca Nam Va Nu A77,58000,58000,3.8,11,41
0,0,Set Bo do thoi trang nam dep hai phong - SG77,415000,415000,0,0,
0,0,SET Ao quan Hoodie nam nu ️ Ao khoac ni thu dong kem quan ulzzang IN KHUNG LONG MAT TRANG form unisex nam nu tre trung,107800,107800,3.8,12,28
14750,5,Bo quan ao the thao nam- Do bo khoac ni nam ke soc Three Stripes Cao Cap,295000,280250,0,0,
0,0,AO HOODIE UNISEX Nam Nu BASIC CAO CAP,85000,85000,5,18,70
0,0,Ao khoac BOMBER ni cao cap cuc lich lam sang trong,109000,109000,0,0,
0,0,"Quan jogger nam GOKING, lung thun va day rut phu hop moi dang nguoi",225000,225000,4.2,49,151
0,0,Hop 4 chiec quan sip dui nam thong hoi CAO CAP ( TANG VONG DEO TAY THOI TRANG ) KEM HOP,194000,194000,4.7,27,91
0,0,Quan dui sip nam Nhat Huy ( Boxer) Kim Lanh,50000,50000,5,9,32
0,0,Bo 3 but ve ui bay Odeme,16990,16990,0,0,
0,0,"Ao thun Nam Nu Vonesa, ao phong Unisex Nam Nu co Size be tu 25-84kg A1",40000,40000,5,8,9
0,0,"Ao khoac cau ca nhieu tui dang luoi nhanh kho
",706303,706303,0,0,
0,0,"Quan jogger unisex the thao, quan ong rong kieu dang jogger mac nha nam nu vai TO ONG ",79000,79000,5,20,42
0,0,"Quan ni the thao 3 soc ong xuong nam nu mac duoc, chat lieu khong bai khong xu, phu hop mac the thao hoac the duc",129600,129600,0,0,
0,0,Quan lung tui hop Nam (Hang xuat ban tai xuong may),29000,29000,3.2,19,156
0,0,Ao hoodies ni bong chonce ms239,239900,239900,0,0,
0,0,Ao Hoodie Ni bong unisex TRON mau Xam/Xam xanh UNISEX/Nam nu unisex ️ Jaystoree,79000,79000,2.5,2,4
0,0,Ao khoac Bomber nam nu unisex ( hang moi ve ),152000,152000,0,0,
0,0,quan baggy nam dài ong con chat dui mem mai nhieu mau,49000,49000,0,0,8
0,0,Quan giap bao ho Komine PK 717,2150000,2150000,0,0,
0,0,Ao Thun Nam Hoa Tiet Dap Van Phong Tron Basic Unisex Thun The Thao Form Rong Thoang Mat Cao Cap Big Sport,85000,85000,4.7,396,934
0,0,AO SO MI NAM LUA TRON CHAT VAI THOANG MAT,199000,199000,0,0,
189000,34,OWEN - Ao So mi Trang dai tay nam Owen soi CAFE dang Regular AR22982D,548000,359000,4.8,20,58
0,0,Quan Tay vai Tuyet mua dai khoa vuong,65000,65000,0,0,
145000,38,"Ao khoac nam cao cap AK Corner co non, vai Xi Nhat day dan 2 lop, co lop hut am cach nhiet, chong gio bui, mac am ap",380000,235000,5,21,56
0,0,"AO KHOAC DU NAM NU,THIET KE HOA TIET SIEU NGAU,CHAT LIEU VAI THOANG MAT LANA FASHION",87300,87300,0,0,
201000,54,"Quan Dui Nam GUZADO,Chat Thun Lanh Cao Cap, Mem Min, Co Gian 4 Chieu, Khong Nhan Nhau,Van Dong Thoai Mai GSR05",370000,169000,4.7,49,157
134000,57,"Ao Thun Nam Ngan Tay Co Tron (5APKB003) Chat Lieu Cotton Cao Cap Tre Trung, Thoang Mat Chinh Hang Biman By BiLuxury",235000,101000,4.8,48,160
0,0,Ao khoac kaki nam 2 lop day dan thoi trang SITAKI cao cap AKK17,170000,170000,3.4,13,21
0,0,Ao khoac du nam nu co non phoi tui hop in chu Nhat ca tinh,99000,99000,4.1,32,95
0,0,Ao Thun Nam Phan Quang 7 Mau GAME FREE FIRE,60000,60000,4.5,206,565
26000,18,Ao Sweater Ni Gau Tay Phoi Dang Rong 2 Mau G114,145000,119000,5,9,21
455000,48,"Ao khoac nam AP51, ao khoac phao nam Casual phong cach Streetwear Han Quoc, Lich su Don gian, ca tinh",950000,495000,4.5,17,30
0,0,AO KHOAC NGOAI DEN PHOI HAI TUI MR SMILE 99 SHOP,225000,225000,0,0,
159200,44,"Quan Bo Nam co dan 4 chieu Thuong Hieu Chandi, chat jean mem min xin xo xu huong 2021 HD82",358200,199000,4.5,51,120
0,0,Quan baggy kaki nam nu - mau den be 2021,108000,108000,0,0,
0,0,"Ao so mi nam Den khong nhan, So mi nam tron dang om Body Han quoc",67000,67000,4.7,13,43
0,0,Hop 5 quan lot tam giac - Quan Sip Nam thong hoi thoang khi khang khuan xuat Nhat,90000,90000,0,0,
46000,44,"Quan short nam co Big Size 115kg lung thun co gian 4 chieu ,quan dui nam the thao cao cap ShopN6 - QSB1 (soc ngau nhien)",105000,59000,4.5,50,214
0,0,ao may o nam det kim dong xuan mau tim than cho nam duoi 55kg,99000,99000,0,0,
115000,50,Ao so mi nam in hinh la co GUMAC ANB6109,230000,115000,4.5,13,39
0,0,"Mau acr phoenix 18m chuyen dung ve tuong va ve ao, len mau cuc dep",99000,99000,0,0,
20000,20,"áo ba lõ nam, áo 3 lõ nam sọi cotton Organic mèm mịn sieu thoáng mát thám hút mò hoi JAMANO",99000,79000,4.8,36,283
0,0,QUAN JOGGER NAM CAO CAP TR250CP,250000,250000,5,1,1
28000,14,Combo 3 Quan Lot Nam Boxer Brief Poly iBasic PANM007 - Mau Ngau Nhien,207000,179000,4.8,32,132
100000,17,AO KHOAC NI NAM - AM AP CHO NGAY DONG,590000,490000,0,0,
0,0,Bo ni nam nu thu dong dai tay the thao thiet ke 3 soc QTD003,201000,201000,4.5,16,50
0,0,Ao Thun Phong Nam Nu Street Tay Lo Sieu Chat,179200,179200,0,0,
0,0,Bo vest nam 2 lop gia 389K / 1 bo - DUKI STORE,389000,389000,4.3,22,46
0,0,Quan JOGGER unisex nam nu co tui truoc day lon thoi trang Han Quoc cuc ky thoai mai,185000,185000,0,0,
81000,45,COMBO 10 QUAN LOT NAM NHIEU LUNG NHIEU MAU - HIEU CM,180000,99000,4.5,359,701
0,0,"Bo The Thao Nam co tron, Hoa tiet dep mat, thun co dan 4 chieu",150000,150000,0,0,
0,0,"Combo 3 Quan Boxer Nam Chat Lieu Thun Cotton Lanh Cao Cap, Quan Sip Nam Co Gian Thoang Mat, Tham Hut Mo Hoi Thuong Hieu BAW (Combo 3 quan mau ngau nhien) NT2201",208500,208500,5,16,56
0,0,"Quan sip dui nam, Boxers nam, Chat vai Cotton mem. min, sieu thoang mat, thun co dan 4 chieu ( 1 cai )",30000,30000,0,0,
38000,42,Combo 5 Quan Lot Nam cao cap | quan xi nam | quan sip nam | nhieu lung | vai cotton 2 chieu | hieu CM | lung lon | cap to | kieu brief | tam giac truyen thong | do lot nam,90000,52000,4.5,199,505
0,0,"Ao so mi nam ngan tay tron basic LCT, form slim fit, chat vai oxford cao cap, nhe thoang mat, tham hut mo hoi - THE DUST",219000,219000,0,0,
14000,7,Ao mong to ghi nam chat vai cao cap vai cuc dep mem mat Thai Khang fashion,199000,185000,4.3,45,171
16050,5,"Ao khoac nam, Ao ret da lon lot long cuu, mac mua dong cao cap",321000,304950,5,1,4
0,0,"ao nam - chat lieu da ca, kieu dang sieu tre trung (D6)",165000,165000,5,13,39
0,0,AO KHOAC JEANS NAM PHOM RONG KIEU DANG HAN QUOC DAY KEO PHOI MU,240000,240000,0,0,
0,0,Com bo 4 ao lot nam hang chat luong cao,99000,99000,4.6,7,28
0,0,Ao lot thong hoi sieu day cao cap D02,62000,62000,0,0,
0,0," Quan lot nam thun lanh nhat ban, quan sip duc khong duong may khong vien",39000,39000,4.7,23,156
0,0,"AO NAM COTTON 2 LOP VA 1 LOP THONG HOI NANO CHONG TIA UV , chong bui NANO LOAI 1",170000,170000,0,0,
0,0,Quan short Jean Nam chat xin rach in hinh phong cach dao pho,129000,129000,4.8,32,78
0,0,QUAN SHORT NAM 3 SOC PHONG CACH,93000,93000,0,0,
0,0,Combo 5 quan ECHT 5 mau short tap gym thẻ thao co gian tham mo hoi,200000,200000,4.1,7,32
0,0,"Ao Khoac Phao Nam Thoi Trang Dong Cao Cap, Ao Day, Am Ap, Form Om Vua, Co 3 Mau Vang, Trang, Den",1298000,1298000,0,0,
39000,50,ao thun nam dai tay ao the thao nam body giu nhiet,78000,39000,5,3,20
0,0,combo 4 Quan sip quan lot nam tron thun lanh cao cap hang hieu (Mau tron),137000,137000,0,0,
426000,50,"Ao Khoac Bomber Nam  4AG2T008 Chat Vai Gio Hai Lop  Chong Nuoc Gore-Tex Dang Cap,Chinh Hang Biman By Biluxury",845000,419000,4.8,18,40
0,0,Ao Khoac Du Nam Co Non Phoi Tui 2 lop AN77 - Den,199000,199000,0,0,
159600,40,Ao so mi Regular Fit Shirt Blamor form om chat lieu lua cao cap hang vnxk_ASM019,399000,239400,5,17,60
0,0,"Blazer Tre Trung sang trong , cuc ky de phoi do",283500,283500,0,0,
91000,36,Ao khoac jean nam Hahaman thoi trang cao cap AKJ06,250000,159000,4.5,23,49
99500,50,"Ao Thun Nam 5S Co Tron (ATSS199) Cao Cap Tre Trung, Thoang Mat N2",199000,99500,4.7,401,949
0,0,Hop 03 Quan Lot Nam Jockey Tam Giac Thun Visco Thoang Mat - J1145 - TH1,275000,275000,5,20,70
0,0,The Playah Shirt,699000,699000,5,58,122
0,0,Bo The Thao Nam Dai Tay - Bo Thu Dong Chat Lieu Ni Cao Cap Mem Min - BD82,230000,230000,2,1,3
106000,42,Ao Khoac Nam Big Size Ao Khoac Du Nam Day Hai Lop Co Cao Chong Nang Tia Uv Chong Gio Chong Lanh Han Quoc Cao Cap QD28 - ShopN6 (Nhieu Mau),255000,149000,4.5,68,127
0,0,"AO KHOAC DU NAM BOMBER NAM FORM RONG,CHAT LIEU THOANG MAT MAU MOI NHAT HIEN NAY",86000,86000,0,0,1
0,0,"AO KHOAC DU , AO KHOAC DU BOMBER 2 LOP UNISEX DANH CHO NAM NU CUC DEP - PHONG CACH HAN QUOC FULL SIZE ",120000,120000,0,0,
179000,60,Ao Thun Nam Polo Co Co Tay Ngan Tron Cao Cap Phong cach Han ZERO,298000,119000,4.5,118,299
0,0,Ao Khoac Da Nam Lot Vai Du Cao Cap,330000,330000,0,0,1
0,0,Ao thun nam nu Vonesa thoi trang cuc chat cotton mem min ca tinh du size 25-84 kg a1,24000,24000,5,5,6
0,0,"Quan lot quan sip Boxer nam vai lua bang tu nhien thoang khi,co gian cao cap SAT",110000,110000,0,0,
159200,44,"Quan Jean Nam dep dan dau xu huong Thuong Hieu Chandi , mau moi form dep ton dang mau hot nhat 2021 MR9051",358200,199000,4.7,42,98
0,0,"Ao Khoac Nam, Khoac Du Nam 2 lop",155000,155000,0,0,
0,0,"Quan Short, Quan Dui Nam Thun The Thao Form Rong Co Dan 4 Chieu Thoang Mat Cao Cap Thuong Hieu Big Sport",125000,125000,4.6,228,720
0,0,ao bomber 20 hinh that unisex,398000,398000,0,0,
0,0,"Ao thun Nam Nu Vonesa, ao phong One Piece Unisex Nam Nu co Size be tu 25-84kg A5",40000,40000,5,9,10
0,0,Ao khoac Bomber ni cao cap,170000,170000,0,0,
0,0,Quan jean nam rach vay son cao cap vai co dan hang quang chau PHUONGNAMSHOP cao cap kv51x,136800,136800,0,0,4
0,0,"Quan Short Drawstrings, ODIN, Quan coc ngan Unisex ODIN Clothing",230000,230000,0,0,
0,0,Ao Thun Nam Tay Lo Unisex Hac JaPan phoi tay ASALA UX-813,49000,49000,4.2,59,409
0,0,AO SOMI NAM NGAN TAY TRON CHU CHAT LIEU DUI,103000,103000,0,0,
20000,10,Quan the thao nam Max Ultra Short kieu dang the thao co  them tui khoa sau tien loi Coolmate,199000,179000,5,16,72
0,0,quan lot (sip) nam thong hoi cong nghe Nhat Ban,125000,125000,0,0,
0,0,Hop 4 quan lot nam tam giac cao cap,89000,89000,4.2,25,63
0,0,Ao Bomber Nam GC Chat Day Dan Cao Cap - Ao Khoac Nam Gc Tron Cuc Dep,679000,679000,0,0,
0,0,Quan Jogger 1 soc - Quan 1 line bo ni thun nam nu phong cach Han Quoc vai day min Unisex,39000,39000,2,1,6
0,0,"AO SO MI LUA SIEU DEP, VAI LUA CAO CAP MEM MIN CHONG NHAN ",160000,160000,0,0,
40000,21,Quan the thao nam Ultra Short co tui khoa keo Coolmate,189000,149000,4.6,27,133
0,0,"Bo coc tay TRUNG NIEN, Hang cuc dep, Gia cuc tot, Chuan dui moc 100%, Day dan, Dep me!",229000,229000,0,0,
0,0,QUAN JOGGER KAKI NAM,49000,49000,1,3,7
0,0,Bo 5 Quan Sip Tam Giac Nam Xuat Nhat (Mau Ngau Nhien),90000,90000,5,5,5
0,0,"Ao ni hoodie Luc Lang Nam Nu full size , chat ni mem min khong bai xu",69000,69000,4.6,150,461
0,0,"Ao khoac da nam cao cap, ao khoac nhan cao cap hang vnxk",319000,319000,0,0,
209000,50,Bo Ni The Thao 4 Mau Thiet Ke Thoi Trang Nang Dong Tre Trung Cao Cap ZERO,418000,209000,4.7,19,52
0,0,Ao gio nam 1 lop xuat khau. Nhan hieu kbs Cong nghe chong nuoc,495000,495000,0,0,
124500,50,Ao Thun Nam YODY Co Tim Cotton Suong Tay Ngan Basic - PPM3997,249000,124500,4.8,17,46
0,0,Quan Dai Nam Li Truoc Vai Dui Cao Cap Kieu Dang Lich Lam VICERO,649500,649500,0,0,
0,0,Ao Khoac Bamber Nam Nu Theu New York,95000,95000,3.9,18,43
0,0,"Ao khoac bomber Varsity ODIN Authentic, ao khoac unisex chan bong ODIN Clothing",500000,500000,0,0,
0,0,Combo 5 Quan lot nam Cao Cap ERIVI'S-060 (Lung Bong Thun Lanh),150000,150000,4.3,550,4869
0,0,Ao khoac_ao gio dua xe Suzuki,850000,850000,0,0,
0,0,Ao khoac gio AMIHOUSE cao cap 2 lop ngan tia UV,177770,177770,3.9,29,76
0,0,AO SOMI “TVD SỌC RÁCH VAI TUA RUA VẢI”,380000,380000,0,0,
65000,25, Bo Quan Ao Nam Nu The Thao 4 Chieu Set Quan Ao Nam Nu Chong Nang Chong Lanh Cao Cap ShopN6 - BQA1 [Co Video],260000,195000,3.9,17,31
47000,41,ao chong nang nam thong hoi nhieu mau,115000,68000,4.5,15,18
130000,29,"Ao So Mi Nam Trang Dai Tay Chinh Hang  Biluxury (SMDT019TRK) Basic Co Be Kieu Dang Sang Trong Thanh Lich Phom Body Fit Ton Dang, Chat Lieu Cao Cap ,Thoang Mat",449000,319000,4.6,8,20
0,0,"Quan jean nam dep dan dau xu huong Julido, mau moi form dep ton dang khong qua om mau EQ01",286200,286200,4.5,92,204
81000,32,Ao khoac kaki tui hop Hahaman nam cao cap 3 mau AKK36,250000,169000,4.3,149,327
159200,44,"Quan Jean Nam cao cap co dan 4 chieu Thuong Hieu Chandi, phong cach han quoc tre trung ca tinh mau moi nhat hien nay MR9068",358200,199000,4.5,43,105
174000,60,Ao thun nam polo theu trai tim  tay ngan thun ca sau cao cap GUMAC ATNB5101 ,290000,116000,5,29,82
0,0," Ao Chong Nang 2 Mat, 2 Lop Pmax Day Dan, Chong Nang, Chong Tia UV, Phu Hop Nam Nu",137000,137000,4.7,63,138
73000,30,Ao Khoac Kaki Nam Ao Khoac Nam Hai Lop FS Chong Nang Chong Lanh Cao Cap KK46 - ShopN6 (Nhieu Mau),240000,167000,4.5,122,285
159200,44,"Ao Khoac Jean Nam den form rong thuong hieu Chandi, Ao Khoac Nam in hinh mau moi hot trend 2021 NT1925",358200,199000,4.6,33,55
0,0,Ao Lot Nam Co Tay Cotton 100% Hang Cao Cap,27000,27000,0,0,2
93000,36,Ao Khoac Nam Big Size Ao Khoac Kaki Nam Hai Lop Big Size Chong Lanh Chong Nang Chong Gio Han Quoc Cao Cap WK35 - ShopN6 (Nhieu Mau),260000,167000,4.1,71,183
143200,44,"Ao Khoac Nam, Khoac Du Nam 2 lop phoi non thoi trang han quoc tre trung cuon hut Thuong Hieu Chandi chat lieu tham hut mo hoi day dan mac thoang mat mau M123",322200,179000,4.5,33,107
150000,50,Ao Phong Nam Polo Tay Ngan Phoi Mau Thoi Trang VICERO,300000,150000,4.5,93,207
0,0,"Quan Au nam Den Vai Cheo Loai Dep,Quan Tay Nam co dan khong nhan dang han quoc",84000,84000,4.1,58,205
259000,50,Ao Khoac Nam 2 Mau The Thao Tre Trung Nang Dong Cao Cap ZERO,518000,259000,4.6,33,75
81000,43,Ao hoodie nam nu form rong Unisex mot mau ca tinh Han Quoc – FORMEN SHOP – FM14GV016,190000,109000,4,189,540
0,0,Ao thun nam nu form rong tay lo Unisex Hi Freesize duoi 69kg,40000,40000,4.6,20,37
10000,5,"Hop 3 quan sip nam boxer chat thun lanh sieu mong, khang khuan, mat vai mem min, mau ngau nhien – FORMEN SHOP – FMCB3QS015",219000,209000,4.3,73,175
190000,28,"Ao Phao Nam YODY, Ao Khoac Phao Co Mu, Sieu Nhe, Sieu Gon, Chong Nuoc, Giu Am Co The - PHM4001",689000,499000,4.7,45,87
0,0,Ao thun Teeworld Saigonese Co Ba Form Rong Nam Nu Unisex,299000,299000,4.8,5,13
0,0, Ao sweater unisex form rong 1987 nam nu phong cach ulzzang Wind thu dong,101000,101000,3.5,4,6
0,0, Quan lot nam lot khe goi cam,39000,39000,4.5,39,119
0,0,Ao ni Hoodie Luc Lang (unisex nam nu deu mac duoc),55000,55000,4.3,37,79
0,0,X - Ao thun den nam in da quang phan quang trong toi chup flash FREESIZE,99000,99000,4.6,10,40
0,0,Quan Jean Nam Mau Moi ️️ Quan Bo Nam Thoi Trang Chuan Hang Shop To To Shop - QJNTT10,148000,148000,4.5,10,32
0,0,"Quan Baggy, quan jean xuong,quan bo nam, nu ,dang ong suong, rong nam- hot trend 2021",159000,159000,3.7,22,54
0,0,"COMBO 3 QUAN LOT NAM cao cap chat vai mem min, kieu dang quyen ru L2930",119000,119000,4.5,75,181
0,0, <FREE SHIP> Do bo nam nu chu A chat vai thun lanh in chuyen nhiet co gian 4 chieu,85000,85000,4,2,15
116000,47,Ao Khoac Du Nam Nu Ao Khoac Nam RG Chong Nang Chong Lanh Co Cao Hai Lop Cao Cap AD62 - ShopN6 (Nhieu Mau),245000,129000,4.3,44,84
21000,23,Quan short nam big size quan sot nam the thao quan dui nam mac nha quan thun nam cotton 4 chieu co gian cao cap ShopN6 - TSB2,90000,69000,4,24,84
0,0,Ao so mi nam mau trang ngan tay vai chong nhan,98000,98000,4.3,29,80
0,0,ao thun tay dai - form rong - Chat Cotton Mem Mat (SP4),153000,153000,5,7,20
0,0,Ao thun nam ngan tay co tim cuc nguc thoi trang Sitaki cao cap ATN04-5 mau,80000,80000,4.6,37,102
0,0,Ao khoac da lot long nam thoi trang cao cap AD021M,264000,264000,4.3,19,38
0,0,"Ao khoac nam lot long cuu vai du gio cao cap chong nuoc co mu thao roi mac mua dong sieu am chong gio giu nhiet unisex nam nu, ao phao nam lot long cuu, ao gio lot long cuu nam vai du cao cap",159000,159000,4.5,26,52
0,0,Quan dui sip nam NHAT HUY dang lo thoang khi,55000,55000,5,9,62
0,0, Quan lot nam boxer sip dui nam dang luoi thong hoi cao cap,164000,164000,4.5,25,76
60000,24,"Combo 3 Quan Sip Dui Nam Quan Lot Nam Boxer Soi Tre Mem Min Sieu Thoang Mat, Co Gian 4 Chieu  Cap Nho MRM FASHION",255000,195000,4.7,121,478
0,0,AO KHOAC NI HOODIE GAU NAM NU UNISEX - GIN STORE,71000,71000,5,1,10
0,0,{SIEU PHAM MUA DONG} AO KHOAC NAM/AO KHOAC PHAO NAM TRAN BONG 3 LOP SIEU AM AP MUA DONG CO SIZE 3XL KEN BLOCK,150000,150000,3.5,18,69
0,0,"Ao thun Nam Nu Vonesa, ao phong Unisex Nam Nu co Size tu 25-84kg B5",40000,40000,5,11,14
314000,58,Ao Khoac Nam The Thao Vai Ni Cao Cap Thoi Trang Zero,538000,224000,4.8,25,42
0,0,Combo 5 Quan Lot Nam Boxer Nhat Ban MUNAFIE - TANG KEM TUI ZIP,130000,130000,4.6,62,163
179000,60,Quan Short Nam Kaki Sieu Nhe Chiet Ly 4 Mau VICERO,298000,119000,4.3,74,189
32000,25,ao Hoodie unisex mat cuoi nam nu kieu han nhieu mau,130000,98000,5,4,11
0,0,Ao thun unisex nam hoa tiet ASALA phong rong UX-21,39000,39000,4.5,16,85
0,0,Ao thun nam  polo phoi mau GUMAC ATNB609,330000,330000,4.7,15,41
0,0,Ao khoac du  nam thoang mat nam tron LV 2019,199000,199000,4.2,23,53
60000,34,"Ao Ba Lo Nam 5S (7 mau), Vai Cotton Mem Mai, Dang The Thao, Tre Trung, Nang Dong, Tham Hut Mo Hoi, Co Gian Cuc Tot",179000,119000,4.5,33,99
134000,57,"Ao Thun Nam Ngan Tay Co Tron (5APKB002) Chat Lieu Cotton Cao Cap Tre Trung, Thoang Mat Chinh Hang Biman By BiLuxury",235000,101000,4.8,16,55
0,0,COMBO 6 QUAN SHORT NAM DAVIE DVS01 ( Quan short mac nha ),329000,329000,4.5,44,106
174500,50,Ao so mi ngan tay Slim Fit Shirt Blamor form om chat lieu lua cao cap hang vnxk_ASM010,349000,174500,5,7,13
0,0,Quan baggy nam cap chun ong con chat dui mat me,80000,80000,3.9,15,39
171000,57,AO SO MI NAM HAHAMAN CARO COTTON CAO CAP NGAN TAY TRE TRUNG SMNT01013,300000,129000,3.6,5,17
0,0,"[COMBO 5] Ao thun 3 lo the thao, ao sat nach nam chay bo cao cap, form chuan, vai Me Thai co gian da chieu",220000,220000,5,6,16
0,0,"Ao hoodie tay ngan dang rong hang thiet ke,chat Cotton cuc mat M3",145000,145000,5,12,28
79200,44,"Ao thun nam co be tay ngan tre trung, chat lieu cotton cao cap mau THUU53",178200,99000,3.9,42,88
41000,12,Hop 03 Quan Lot Nam Jockey Trunk Thun Visco Thoang Mat - J1146 - TH1,329000,288000,4.7,6,24
120000,44,"Quan jean nam den tron Julido Store, chat jean co dan 4 chieu ton dang nam tinh BC20",270000,150000,4.7,24,71
0,0,"Quan lung mac nha chat Kate tron, mem, min, thoang mat, mau xam - FORMEN SHOP - FMTS011B",109000,109000,4.2,33,155
156000,38,"Ao Thun Nam Polo Ngan Tay Co Be Chinh Hang Biman by BiLuxury (5APCT002),Chat Polyester Cao Cap, Kieu Dang Body Fit Lich Lam,Tre Trung, Nang Dong",415000,259000,4.5,9,19
21000,30,Quan dui nam kate mat mac ngu thoai mai Camus,70000,49000,4.3,8,88
0,0,"AO THUN NAM TAY LO FROM RONG,THIET KE HOA TIET SIEU NGAU THOI TRANG KING STORE",55000,55000,4.5,25,89
0,0,Bo Quan Ao Nam Ao Ni Nam Co Tron Dai Tay Quan Jogger Nam Bo Gau Thoi Trang Zenko TOP NAM 1000111 + QUAN NAM 1000069,109000,109000,1.6,5,18
0,0,Ao Khoac Nam 2 Mat Cuc Dep,92000,92000,4.3,27,137
42000,20,Quan Lot Nam Jockey Dang Trunk Boxer Seam Free Mau Trang Mem Mai Khang Khuan - JMMB9118-10,210000,168000,4,4,12
279000,52,Ao Khoac Nam Thoi Trang Cao Cap VICERO,538000,259000,4.5,38,213
0,0,Combo 5 quan sip nam Manufie det kim cao cap kem tui zip sieu chat,125000,125000,5,1,4
0,0,"Quan Jeans, baggy den nam ong suong, rong, hottrend 2021",0,159000,5,8,
0,0,"AO HOODIE UNISEX NAM NU, QUY NHO VAI NI POLY",75000,75000,4.1,7,23
0,0,"Ao Khoac Nam Chat Gio Pmax (3 mau), Co 2 Lop, Co Mu, Dang Tre Trung, Chong Tham Nuoc, Chong Gio, Thich Hop Nam Nu",169000,169000,4.7,29,62
0,0,"Quan Jogger Nam Nu Ong Bo Thun Tron Basic The Thao, Quan Tap Gym Soc Dai Lung Thun Day Rut Co Dan Cao Cap Big Sport",145000,145000,4.5,62,115
54890,11,(Ao Hoodie Van Toan ban dac biet ) - Ao Hoodie Reunion,499000,444110,5,11,17
0,0,Combo Ao & Tui - VATO9'SZONE,359000,359000,5,12,16
0,0,Combo 4 Quan Lot Nam Xuat Nhat - Quan Sip Nam Thong Hoi Cao Cap - Chat Lieu Mem Min Mat Lanh,105000,105000,4.3,18,65
0,0,Ao Khoac Hoodie Nam DJ MarshMello Dep Nhat Form Rong Thoai Mai Vai Ni Day,189000,189000,4.6,25,78
0,0,Ao Hoodie Ni Ngoai Unisex Nam Nu Angel Form Rong Thoai Mai,110000,110000,2.8,4,9
291000,42,"Ao khoac da lot long cao cap LADOS - 105 form chuan dep, chat day mem KHONG BI BONG TROC",690000,399000,4.5,16,26
111200,44,Ao Thun Polo Nam Co Be Tay Ngan Chat Lieu Cotton Nhieu Mau Thoi Trang Men Luxury PL10,250200,139000,4.7,19,85
0,0,"Ao Thu Dong, Ao Thun Nam - Nu Dai Tay - Hang In Chuan - Chat Lieu Ni Poly 2Da Cao Cap - N05",148000,148000,4.2,12,32
0,0,"Quan Baggy Nam Kaki Ong Suong Unisex - Kieu quan baggy kaki nam nu thun vai den va be tan, xam",81900,81900,4.2,57,160
143200,44,"Ao Khoac Nam, Ao Khoac Du Nam Nu Hai Lop Chong Nang Chong Gio, Ao Khoac Nam Thu Dong Cach Nhiet, Ao Khoac Unisex Phong Cach Han Quoc Thuong Hieu Chandi Ma AKD64",322200,179000,4.1,15,39
144000,44,"Quan Sot Jean nam co dan 4 chieu Thuong Hieu Chandi, phong cach han quoc mau moi nhat 2021 HD221",324000,180000,5,37,78
0,0, Ao Len Nam Co tron ,230000,230000,2.7,7,18
0,0,Ao Thun Nam Phan Quang In Tee BOBUI Sai Gon Phan Quang - Ao thun BOBUI SaiGon Reflective Phan quang,59000,59000,4.1,43,84
0,0,"Combo 3 Chiec Quan Lot Nam Boxer Det Lien Cao Cap, Co Dan 4 Chieu CALUCI CA - 13 (Giao Mau Ngau Nhien) - Hang Chinh Hang",330000,330000,5,26,52
0,0,Ao phong unisex 8TS20S042,99000,99000,4.7,49,119
0,0,Quan sot jeans Nam Wach Ben dep LD46,79000,79000,3.6,29,87
0,0,Quan jogger nhung co day khoa chan cap chun 2 tui cheo chat dep,88000,88000,5,11,21
61000,27,Ao thun nam Polo co be PiGo chuan phong cach AB19 (xam),230000,169000,5,14,70
159200,44,"Quan Jean Nam cao cap co dan 4 chieu Thuong Hieu Chandi, phong cach han quoc tre trung ca tinh MR9015",358200,199000,4.7,41,78
79200,44,"Ao thun nam co be tay ngan tre trung, chat lieu cotton cao cap mau THUU48",178200,99000,4,23,99
29000,30,Quan dui nam THE 1992 Quan short cartoon unisex nam nu,98000,69000,4.7,165,624
120000,40,Combo 5 Quan sip nam thong hoi chat cotton thun lanh min mat - ZQ204,299000,179000,3.9,12,104
173000,51,Bo Mac Nha The  Thao Nam Mua He Thun Mong Cao Cap ZERO - BTT17 DEN - XXL,338000,165000,4.3,8,16
0,0,Ao so mi nam co tru chui dau dai tay,149000,149000,4.7,30,146
396000,50,"Ao khoac gio nam chinh hang Aristino AJK001W8, ao gio polyester day dan, dung dang, khang nuoc tot, lam van phong hay di phuot deu phu hop.",795000,399000,4.8,13,27
0,0,"[COMBO 5] Quan dui nam tap gym, quan short the thao vai thun vnxk sieu nhe mem min, co gian tot, van dong thoai mai",159000,159000,4.3,12,25
144000,44,"Quan Sot Jean nam co dan 4 chieu Thuong Hieu Chandi, phong cach han quoc mau moi nhat 2021 MS02",324000,180000,4.5,31,99
0,0,AO KHOAC LOT LONG CUU 3 LOP NAM,475000,475000,3.5,4,9
0,0,"Ao khoac nam cach nhiet GOKING 2 lop, vai du am ap, can gio hieu qua, thich hop dong va thu dong (Mau ghi xam)",235000,235000,4.5,153,540
0,0,"Ao Thun Tay Lo,áo phong nam nũ in Phan Quang 7 Mau Love Myself - Den, Tráng TL123 Setstore",45000,45000,3.8,4,21
0,0,"Ao thun Nam Nu Vonesa, ao phong Unisex Nam Nu co Size tu 25-84kg B10",40000,40000,5,9,9
0,0,"Ao Blazer Nam, Ao Vest Nam phong cach Han Quoc Dang Rong Retro BZ001",814700,814700,0,0,
299000,50,Ao Khoac Nam 2 Lop Tran Long Thoi Trang VICERO,598000,299000,4.7,27,46
59000,50,Ao phong unisex nam nu tay lo thun form rong teen co tron oversize cotton gia re basic den trang tee pull TOM,118000,59000,4.7,7,12
657000,60,Quan dai the thao nam New Balance - MP03905AG,1095000,438000,4.7,7,15
0,0,Ao thun polo nam co co be phoi soc ngang ca sau cao cap tre trung ND02,149000,149000,4.1,168,652
0,0,"Quan Short Nam Chat Gio Co Gian Thoang Mat,Quan Dui Nam 4 Mau Mac Nha Nang Dong",39000,39000,1.8,5,32
59000,50,Ao thun nam nu unisex tay lo phong form rong teen co tron oversize cotton gia re basic den trang tee pull SONIC,118000,59000,3.9,15,35
316000,56,"Ao Khoac Gio Nam (4AG1T001) Co Mu Mot Lop Chong Gio Chong Nuoc Nhe ,Nhieu Mau Sac,Hang Cao Cap Chinh Hang Biluxury",565000,249000,4.5,15,41
21000,26,"Quan lot nam ARISTINO dang Brief, quan sip tam giac nam chat lieu Bamboo tu nhien, mem mai va thoang mat - AC-06",80000,59000,4.8,10,128
89000,45,Quan ong suong kaki nam trung nien chat vai day mem min co gian hang xuat khau quan dai kaki cao cap ben dep co nhieu mau nhieu size 50- 85kg,199000,110000,4.3,105,263
38000,55,Ao thun ba lo nam the thao Everest,69000,31000,4.7,88,300
0,0,Ao Khoac Chong Nang Nam,99000,99000,3.6,52,159
183000,54,Quan Kaki Nam Chat Cao Cap Sieu nhe Dang Au ZERO Phong Cach Cong So,338000,155000,3.8,82,173
0,0,"Combo 4 Quan Lot Boxer Nam Hoa Tiet Dep Mat Quyen Ru Thong Hoi Thoang Mat , Quan Sip Dui Hoa Tiet An Tuong Cao Cap, Thiet Ke 3D Co Gian 4 Chieu Thoai Mai, Thich Hop Di Boi Di Bien (GIAO MAU NGAU NHIEN)",199000,199000,3.6,16,29
151000,50,Ao Thun Nam Polo in Hoa Tiet HAHAMAN thoi trang cao cap ATPL01006,300000,149000,5,21,23
0,0,"Combo 3 Chiec Quan Lot Nam Tam Giac Chat Lieu Cotton Mem Mai, Thoang Mat CALUCI CBF18-01 (Giao Mau Ngau Nhien) - Hang Chinh Hang",210000,210000,4.8,31,48
103200,44,"Ao Thun Nam Ngan Tay Chandi, Chat Thun Cotton Xin Mau Moi NT17",232200,129000,4.6,41,140
0,0,QUAN LOT NAM ROSSO,55300,55300,4.3,39,165
0,0,Ao thun nam form tre trung vai thun mem mat free size duoi 65kg,25500,25500,4.1,16,65
19000,12,"Ao Khoac Du Nam Truot Nuoc Cao Cap Big Size,Co Tui Trong AK223",158000,139000,4.5,11,45
159200,44,"Quan Jean Nam cao cap chat bo sieu co danThuong Hieu Chandi, form dung dang dep mau moi sieu hot 2021 MR9034",358200,199000,5,32,61
0,0,Ao thun XE TA CUC Uniex N7 Basic Tee phong tron nam nu tay lo oversize form rong Han Quoc,139000,139000,4.5,14,31
99500,50,"Ao Thun,Phong Nam Thoi Trang Ngan Tay Co Tron  Unisex Phom Rong Oversized  Discovery  Tuto5 Cao Cap 100% Cotton AT07",199000,99500,4.8,177,596
0,0,"Ao da nam - kieu dang hien dai, style Han Quoc (R8)",286000,286000,5,4,15
70000,29,Ao khoac jean Hahaman nam thoi trang cao cap 03,245000,175000,4.1,22,67
109000,46,Combo 10 quan lot nam CITYMEN,238000,129000,4.5,142,595
0,0,Ao So Mi Nam Kate Phoi Soc F6229 Sang Trong,130000,130000,4.5,121,277
0,0,"Ao khoac du nam nu unisex kieu bomber form rong, 2 lop day dan",95000,95000,3.9,7,15
0,0,"Ao Polo nam co be ngan tay, chat lieu cao cap, thoang mat, ben mau, thiet ke tre trung – FORMEN SHOP – FMPS086",198000,198000,4.5,109,390
26000,50,Ao Thun Nam Tay Lo Unisex Hac JaPan,52000,26000,4.2,38,108
111200,44,"Ao Khoac Jean Nam phoi rach thuong hieu Julido Store, Ao Khoac duoc yeu thich 2021 mau KR01",250200,139000,4.5,97,193
111200,44,"Ao so mi nam trang tron Julido, chat lua khong bai nhao khong xu long ton dang om form mau TOP",250200,139000,4.2,63,164
0,0,Quan sip xi dui nam cao cap quan lot nam dui co gian 4 chieu 5D 45-70kg alex,14000,14000,4.3,14,41
46000,50,Ao thun tay lo cotton thoang mat form rong  vien chu nhat (unisex nam nu deu mac duoc),92000,46000,3.3,23,56
0,0,"Quan Jean Nam , Quan Bo Mau Xanh Co Gian Phong Cach Thoi Trang Han Quoc Cao Cap ms668",129000,129000,4.7,3,11
0,0,"ao giu nhiet da ca,thoi trang,full sz 35-95kg,hang Unisex loai 1 ( ma T41)",190000,190000,5,14,42
0,0,Ao thun nam nu Vonesa thoi trang cuc chat cotton mem min ca tinh,24000,24000,5,4,4
111000,40,Ao khoac kaki nam tui hop Hahaman cao cap mau moi AKK72 8 mau,279000,168000,4.5,39,117
0,0,AO GIU NHIET NAM- CO 3 PHAN - MAT TRONG LOT NI ,39000,39000,1,1,4
135000,45,Ao khoac hoodie ni Unisex co mu phong cach Ulzzang phoi mau Gradient T80,300000,165000,4.5,24,62
59000,50,Ao thun nam nu unisex tay lo PEACE phong form rong teen co tron oversize cotton gia re basic den trang tee pull ,118000,59000,5,6,16
0,0,"Quan Bo Nam cao cap co dan 4 chieu Thuong Hieu Chandi, phong cach han quoc tre trung ca tinh mau moi nhat hien nay MR9066",199000,199000,4.5,44,77
0,0,"Ao khoac nam cao cap GOKING, vai da ca day 100% cotton chong nang va giu am hieu qua",289000,289000,4.6,109,229
60000,34,"Ao Sat Nach Nam 5S (4 Mau), Chat lieu Premium Cotton Sieu Tham Hut, Thoang Mat, Van Dong Thoai Mai (ATT21023)",179000,119000,5,28,97
297000,50,"Quan jeans nam GUMAC QJNB7104 co banmau xanh, nang dong tre trung",595000,298000,5,12,43
0,0,Ao thun nam co co tay ngan vai Thun Cotton Mem min co gian thoang mat,75000,75000,4.3,18,35
0,0,Ao khoac du GYM kieu bomber chat du ngoai 2 lop chuan szie L va XL nam nu cap doi deu mac duoc,97000,97000,4.8,10,25
0,0,"Ao khoac gio nam nu cao cap 2 lop, chat vai gio trang bac, day dan, thoang mat, can gio, can bui mau ao Hot 2021 - PDV50.",174000,174000,4.2,5,15
0,0,"Áo thun nam tron cỏ tròn, áo ngán tay khong cỏ TS306 TORANO, vải cotton mèm, co giãn, dày dạn",169000,169000,4.6,42,134
150000,27,"Ao Khoac Gio 3C YODY Nam The Thao Phoi Lung, Can Gio, Can Bui, Chong Tham - AKM4027",549000,399000,4.6,56,105
0,0,Quan lot nam boxer Su Duc Thun Lanh - Quan sip nam,54500,54500,3.9,16,67
0,0,"Ao So Mi Nam tay ngan Hoa Tiet Loang Mau Basic form rong mem min. thoang mat, de phoi do",120150,120150,3.9,14,32
0,0,Ao Khoac Du Nam Cao Cap STYLE Han Quoc,285000,285000,5,9,18
127200,44,"Quan bo nam co dan 4 chieu Julido Store, chat jean mem min xin xo xu huong 2021 BC1 - 28",286200,159000,0,0,357
101000,22,"Ao khoac nam lot long AL20, ao khoac len nam Cardigan day am",450000,349000,4.7,13,29
50000,34,Ao Khoac Ni Bong Theu MOOS Form Rong Xe Ta Ulzzang co mu 3 mau ca tinh,145000,95000,5,10,15
0,0,Ao Thun Tron cho ca Nam va Nu dep chat lim,29999,29999,4,48,116
75000,44,"Do bo nam quan ao the thao in chu futuar (45-70kg) MUA HE chat thun lanh mac mat /Do Bo The Thao Nam/Set Bo Quan Ao The Thao Nam/do bo mac nha/do bo dep, DO BO MAC NHA FUTUAR NAM NU, QUAN AO THE THAO THUN MUA HE NHE MAT.",170000,95000,4.7,9,26
0,0, Ao ni Hoodie tron du mau (unisex nam nu deu mac duoc),64000,64000,4.5,79,213
0,0,Ao polo nam GUMAC ATNB799 phoi soc ,395000,395000,4.7,31,87
0,0, Quan Dui Nam Theu Hinh Nai Size tu 50 - 85kg,49000,49000,4.1,11,74
0,0,Combo 5 Ao Thun Nam In Hinh Form Tre Trung Nang Dong Free Size Duoi 65kg,99000,99000,5,5,16
0,0,Quan dui ngu nam,37000,37000,4.5,4,23
0,0,"Ao so mi nam co Tau Mau Xam Tieu Dam, So mi nam co Tru dang om dep",108000,108000,4.6,36,88
0,0,"Ao khoac nam 2 lop GOKING, vai du am ap, can gio hieu qua, thich hop dong va thu dong (Mau Do)",235000,235000,4.3,80,306
79200,44,"Ao thun nam the thao tay lo, co tron dep, tre trung, mac thoang mat, tham hut tot CHANDI HH14",178200,99000,4.8,17,55
16000,17,"Quan lot nam ARISTINO dang Brief, quan sip tam giac chat lieu Modal tu nhien, mem mai va thoang mat gap 2 lan so voi soi vai thong thuong - ABF1616",95000,79000,5,7,35
181000,37,Bo Quan Ao Thun Nam Thoang Mat Mua He AKUBA | 01J0004,489000,308000,2.5,8,19
82000,41,"Ao thun ba lo nam sat nach AKUBA form oversize thoai mai, chat lieu single cotton 100% soi tu nhien J553",199000,117000,4.7,17,95
0,0,"Ao so mi nam den trang dai tay cong so cao cap chat vai lua co gian nhe form slimfit om dang thoi trang Han Quoc, ao so mi nam dai tay den trang lua cao cap cong so Han Quoc",66000,66000,4,5,16
0,0,"Combo 4 Quan Lot Nam Tam Giac Thong Hoi Lung Nhat Thoang Mat , Quan Sip Thong Hoi Cao cap ( Giao Mau Ngau Nhien )",79000,79000,4.5,14,46
276000,49,"Ao thun nam dai tay ARISTINO, ao SweatShirt chat lieu Poly-Cotton ben mau, thoang khi, hoa tiet hoa Ban phong cach tre trung nang dong",565000,289000,4.8,9,16
0,0,Quan Jogger Nam Nu 3 Soc Form Ong Rong De Xuong Hoac Rut Day Bo Gau Vai Min Nang Dong Tre Trung,87000,87000,4.5,17,68
143200,44,"Ao Khoac Nam, Ao Khoac Kaki Nam Nu Hai Lop Phoi Non Khong Thao Roi Chong Nang Chong Gio, Ao Khoac Nam Thu Dong Cach Nhiet, Ao Khoac Unisex Phong Cach Han Quoc Thuong Hieu Chandi Ma NT2206",322200,179000,4.1,9,17
159200,44,"Quan Jean Nam cao cap co dan 4 chieu Thuong Hieu Chandi, phong cach han quoc tre trung ca tinh MR9055",358200,199000,4.7,19,38
0,0,"Ao thu dong, chat ni da ca - dai tay form rong cho cac MEN (T41)",178000,178000,5,16,33
0,0,Ao so mi nam coc tay May 10 ma 010121174OLLT 454,156000,156000,4.8,10,30
0,0,Quan nam Quan dui dai nam ong suong Form Slimfit dang au,79000,79000,4.7,9,44
0,0,"Quan jogger nam tron chat gio du mem min phoi mau Gradient, phong cach duong pho",158000,158000,0,0,
0,0,Quan jogger kaki nam tui hop New arrival 04,79000,79000,1,1,1
75000,31,Ao Khoac Kaki Nam Hai Lop Co Be Tui Hop Chong Nang Chong Lanh Chong Gio Cao Cap KK48 - ShopN6 (Nhieu Mau),240000,165000,4.5,63,131
189500,50,"Ao Polo Nam 5S (4 Mau), Chat Lieu Mem Mai, Thoang Mat, Chong Nhan, Phom Dang Om Tre Trung, Nang Dong (APC21019)",379000,189500,4.7,49,144
0,0,"Quan Jean Nam Vovesa Mau Moi, Dang Om Tre Trung, Nam Tinh Q3",99000,99000,4.6,5,17
51000,46,quan ong rong dang jogger trai tim chat thun tre trung ca tinh,110000,59000,5,4,11
0,0,Quan kaki Cap chun Q90,297000,297000,4.7,57,169
0,0,Quan Kaki Baggy Nam Nu Ong Suong ma Q002,85000,85000,4.1,8,25
153000,51,Quan Jogger kaki THE 1992 basic 5 mau tron,300000,147000,4.3,18,52
0,0,Ao thun nam co co trung nien vai cotton xin loai ao thun cho nguoi lon tuoi co tui,99000,99000,4.5,58,145
0,0,Ao Khoac Du Bomber TSM Tui Co Khoa Keo Ao Khoac Gio Nam Nu Couple Re Dep Chong Nang - Bomber Jacket -HIEN LINH SHOP AO KHOAC ,85000,85000,5,8,21
126000,48,"Ao thun nam dai tay Aristino, Ao giu nhiet nam om body chat lieu  Polyester ket hop Tencel mem mai, giu am cuc tot - KLT004W8",265000,139000,4.5,17,52
136000,42,Combo 5 quan lot nam 5 mau dang dui bang lung Lon - Thun lanh cuc mat.,325000,189000,4.6,14,38
0,0,Ao thun phan quang tay lo nam nu ZORO,85000,85000,4.5,33,83
0,0,"[COMBO 4] Quan ngu nam, quan dui nam cotton cao cap nhieu mau sac, mac nha, mac di bien di boi",175000,175000,5,11,31
127200,44,"Quan bo nam co dan 4 chieu Julido Store, chat jean mem min xin xo xu huong 2021 BC1 - 29",286200,159000,0,0,86
79200,44,"Ao thun nam the thao tay ngan, co tron dep, tre trung, mac thoang mat, tham hut tot CHANDI HH13",178200,99000,4.2,26,117
93000,40,"Combo 5 Quan lot nam, sip cheo nam xuat Nhat thoi trang cao cap ZBra - ZQN08 (Mau ngau nhien)",232000,139000,4.3,128,438
0,0,Ao Thun Tay Lo SAIGON mau Trang/ Den Nam nu Unisex - ao phong tron in chu saigon,109000,109000,4.7,13,30
0,0,"Ao thun One Piece Zoro T11 mau moi cuc dep, co size be cho tre em / ao thun Anime Manga Unisex Nam Nu, ao phong thiet ke co tron basic coc tay thoang mat",49000,49000,4.7,159,363
0,0,Ao gio ao khoac du nam nu 404 - ao khoat nam-ao khoac nu-HS,74000,74000,0,0,
159600,40,Ao so mi Slim Fit Shirt Blamor form om chat lieu lua cao cap hang vnxk_ASM040,399000,239400,5,13,28
250000,71,Ao So Mi Nam Caro Coc Tay VICERO Tre Trung Nang Dong,350000,100000,4.2,18,126
158000,40,"Quan Short ,Quan Dui Nam Kaki Chinh Hang Biluxury (5QNKB003) Chat Cotton Cao Cap Thoang Mat Mem Min Khoa Cuc Tien Dung Phong Cach Tre Trung",399000,241000,5,20,57
11000,44,"Quan lot nam | quan lot nam nhieu loai lung vai cotton cao cap , lung cao 4cm , tham hut mo hoi tot , mang lai cam giac de chiu khi mac ( lung thun va mau sac giao ngau nhien )",25000,14000,4.6,9,59
39000,28,Combo 02 Quan Dui Nam Novelty - Mau Ngau Nhien,138000,99000,3.9,70,457
0,0,AO KHOAC DU NAM CO NON,99000,99000,1,1,1
0,0,Ao Thun Nam Phan Quang Tuong Lai Nho Nha Vo,59000,59000,4.5,111,290
0,0,"Ao da nam - kieu dang hien dai, style Han Quoc (R8)",316000,316000,5,6,17
61000,31,Ao so mi nam caro cao cap ngan tay Hahaman HM04,200000,139000,4.5,16,62
0,0,quan dai tay au han quoc thoi trang,99000,99000,4.1,8,31
0,0,"Ao thun Nam Nu Vonesa, ao phong Unisex Nam Nu co Size tu 25-84kg B3",40000,40000,5,8,13
276000,39,Ao khoac varsity bomber The Bad God Mild,700000,424000,4.8,6,13
80000,45,Ao So Mi Nam Khong Nhan LAVIC 523,179000,99000,4.7,86,257
144000,44,Ao khoac nam chat kaki 2 lop xin xo Julido Store mau moi theo xu huong thoi trang Trend QA02,324000,180000,4.3,54,131
0,0,"Quan dui nam the thao, tap gym, chay bo, chat lieu thoang mat 4 chieu co gian tot, form om body",59000,59000,4.7,11,49
124000,44,"Quan jean nam cao cap co dan 4 chieu Julido, phong cach hang quoc MM20",279000,155000,4.3,176,439
212000,44,"Quan tay nam di hoc ong dung ton dang AKUBA form slimfit chong nhan, co gian, mem mai, ben mau 01K3008",481000,269000,4.7,23,51
26000,50,Ao Phong Nam Trang Tron Chat Cotton Mat THUNTRANG59 - Thun Trang,52000,26000,2.7,10,127
0,0,Quan jogger thun soc Caro dai Nam Nu unisex ong suong mau xanh den,89000,89000,3.8,9,21
0,0,AO KHOAC BOMBER NAM NU VAI MERO CAO CAP HOA TIET THEU ARP HANG CAO CAP HOT TRIEND 2021,149000,149000,4.5,34,90
0,0,"Ao khoac da nam , ao da nam . ao khoac nam",164000,164000,4.8,16,39
205000,41,"Ao khoac Jeans day dan , form dep cuc nam tinh LADOS - 2033",500000,295000,4.3,7,15
80000,24,"Quan jogger kaki cao cap Amazing, lung thun co day rut, ong bo, thoi trang unisex, mau sac classic de phoi do, co big size ",339000,259000,4.7,80,200
0,0,"Quan jogger nam tui hop chat kaki mem min, phong cach duong pho",79000,79000,1,2,6
314500,50,"Ao Khoac Nam Vai Gio 5S (6 mau), Mu Lien , Chong Tham Nuoc, Can Gio, Giu Am Cuc Tot (AKG21009)",629000,314500,4.7,35,88
142500,50,"Combo 3 Quan Sip Dui Nam Boxer 5S (5 Mau), Chat Lieu Premium Cotton, Sieu Tham Hut, Khang Khuan Tot (X3-SIP21003BOX)",285000,142500,4.8,24,58
0,0,Bo pijama nam dai tay trung nien vai cotton mac mat thoai mai cho nguoi gia loai bo do trung nien pijama mac nha loai soc (Giao ngau nhien),149000,149000,4.5,12,63
0,0,"Ao Thun Nam Phan Quang In mat sharingan cua Uchiha Obito - ke si tinh vi dai, anime Naruto , ao chat, di dem, di phuot bao ngau, nhin da mat",59000,59000,4.6,120,252
0,0,"Ao khoac nam, Ao khoac jean, bo nam rach from rong_mau xanh ",199000,199000,4.5,8,24
270000,42,"Quan Jean Nam 5S (3 mau), Chat Cotton Premium Sieu Min, Mem Mai, Khong Bai Xu, Co Gian Tot, Phom Dang Tre Trung",639000,369000,4.7,18,46
111200,44,Ao khoac nam chat du 2 lop xin xo Julido Store mau moi theo xu huong thoi trang Trend006,250200,139000,4.3,12,37
0,0,Ao Thun Tron Nam - Nu Unisex,39000,39000,4.6,16,33
111200,44,Ao khoac nam chat du 2 lop xin xo Julido Store mau moi theo xu huong thoi trang Trend EM02,250200,139000,3.7,7,35
0,0, QUAN SOT KAKI NAM LUNG THUN CO DAY RUT,45000,45000,3.8,32,106
0,0,"Quan lot nam boxer ""Chuyen dong"" Hunk Active Cool tui Kangaroo dat theo chieu doc mau xanh phoi den",129000,129000,4.6,8,29
105000,70,Quan short du gio HAHAMAN the thao co gian cao cap QD0026,150000,45000,4.5,16,67
0,0,Ao khoac du From rong Xam ( Freesize ) -AKD02,140000,140000,5,3,35
0,0,Ao thun nam ngan tay co tru thoi trang SITAKI cao cap ATN01,120000,120000,5,17,33
0,0,Ao Thun Tay Lo Unisex U-019,29000,29000,4.2,17,110
0,0,Quan jogger kaki nam MK CLEVER QJKB078,180000,180000,3,11,45
159200,44,"Quan Jean Nam cao cap chat bo sieu co danThuong Hieu Chandi, form dung dang dep mau moi sieu hot 2021 MR9036",358200,199000,4.6,37,72
127200,44,"Ao So Mi Nam lua phoi hoa tiet cao cap Thuong Hieu Chandi, xu huong moi nhat nam 2021 mau SM5",286200,159000,4.3,23,69
0,0,quan short tay au caro thoi trang cao cap V&N,65000,65000,3.9,16,52
127200,44,"Ao So Mi Nam lua tron cao cap Thuong Hieu Chandi, xu huong moi nhat nam 2021 mau SM3",286200,159000,4.6,32,52
0,0,AO PHAO NAM CO NON SIEU AM AP MUA DONG KHONG LANH PL9,150000,150000,2.7,6,16
126000,59,Ao thun tay dai nam hahaman co tron dang the thao nhieu mau ATDT01,215000,89000,4.5,20,48
127200,44,"Quan jeans nam co hoa tiet dep hang moi ve, dan dau xu huong da co mat tai Julido Store mau moi 00001",286200,159000,4.2,42,73
0,0, Combo 3 Ao Thun Nam Trung Nien Day Mem Sieu Mat Freesize Duoi 65kg Loai Nhieu Hoa Tiet,79000,79000,4,3,11
0,0,Quan short nam cao cap QSTT,59000,59000,2.3,4,25
0,0,Ao So Mi Nam Dai Tay Hoa Tiet Soc 621 Thoi Trang Cao Cap PONIVA Chat Vai Cao Cap Mem Mai Tham Hut Mo Hoi Tot,145000,145000,4.5,12,36
79200,44,"Ao thun nam co tron tay ngan tre trung, chat lieu cotton cao cap mau THUU18",178200,99000,4.6,20,50
0,0,Ao thun nam trung nien vai cotton lanh mem min mac cuc mat loai ao thun nam tay ngan co co co,79000,79000,4.5,21,47
0,0,Ao Khoac Hoodie Nam Phan Quang Mau Moi Vai Ni Day Kieu Dang Thoi Trang Hinh In Hot Trend,189000,189000,4.7,28,59
29000,50,Ao thun nam nu unisex from rong in hinh chu meo cam chao may man,58000,29000,4.5,5,13
0,0,Blentino quan tay Cotton namDd19315-11,485000,485000,5,9,32
0,0,"Ao khoac du 1 soc ,ao khou du , ao khoac gio , ao khoac nam nu mac vai du  co non trum dau 2 lop chong nang chong lanh tot",99000,99000,4,6,20
180000,42,Ao Khoac Da Nam Den Black Leather Cao Cap AKD21,425000,245000,3.8,67,575
0,0,Ao mong nam trung nien tay ngan co co vai cao cap loai 1 sieu dep hang nhap khau Thai Khang,199000,199000,4.5,14,33
270000,44,Ao So Mi Nam Tay Dai Hoa Tiet Soc AKUBA | 02A921,609000,339000,5,10,17
0,0,AO SO MI NAM LUA HAN QUOC HOA TIET ANH KIM 5D SIEU SANG TRONG CHO PHAI MANH- CO BIGSIZE(45-100KG),99000,99000,3.7,77,231
0,0,Ao thun nam tay lo co co vai ca sau loai cao cap mem min co gian tot tham hut mo hoi mac mat co nhieu size 55-85kg,79000,79000,4.3,30,89
126000,49,"Combo 2 quan the thao nam ngan Sport vai thun Poly 2 Da thoang mat, do co gian cao hut am tot - Mau den va xanh den",255000,129000,4.7,18,44
0,0,Quan Kaki Nam Mau Ghi Dam Dang Cong So KAKIXAM02,108000,108000,3.4,16,138
15000,12,"Ao ba lo nam/ 3 lo nam cao cap, soi cotton mem min sieu thoang mat, tham hut mo hoi cuc tot, co dan 4 chieu MRM FASHION",125000,110000,4.7,241,1154
0,0,Combo 5 Quan sip dui nam thong hoi thoang QS8411E,79000,79000,4.5,17,57
202000,45,"Ao thun nam dai tay Sweatshirt  Aristino, ao thu dong  ke tre trung phong cach, chat lieu PE-Cotton ben mau, thoang khi - ASW004W9",450000,248000,5,9,19
59040,41, Ao thun unisex form rong tay lung nam nu han quoc in chu New designer,144000,84960,5,8,26
0,0,"Combo 5 Quan Lot Nam Boxer, Quan Sip Dui Nam Det Kim Cao Cap, Sieu Thoang Mat, Sieu Tham Mo Hoi, Sieu Ben",68897,68897,4.1,22,47
111000,48,"Ao Thun Nam Ngan Tay   (5APKB002XNG) Chat lieu Cotton  Cao Cap Tre Trung, Thoang Mat Chinh Hang Biman By BiLuxury",230000,119000,5,12,34
29000,30,Quan short nam THE 1992 cartoon Quan dui nam mac nha,98000,69000,4.5,19,112
81590,41,Ao Thun Nam Tay Lo Unisex co Tron chat lieu vai cotton mau trang form rong in chu Japan 3 phong cach doc chat TheNgaustyle,199000,117410,5,83,175
0,0,Bo Ni Tron Thoi Trang Nam ,250000,250000,3.9,27,78
209000,50,Bo Ni Nam VICERO Chat Cotton Khong Xu Khong Phai,418000,209000,4.5,90,230
111200,44,"Ao so mi nam Julido, chat lua khong bai nhao khong xu long ton dang om form mau JL16",250200,139000,4.7,44,96
0,0,Ao so mi dui nam tay ngan trung nien SIEU MAT mac thoai mai loai ao so mi cho nguoi lon tuoi tron,99000,99000,4.7,36,82
0,0, Quan sip quan lot nam thun lanh cao cap sieu nhe,34000,34000,4.3,7,22
0,0,"Quan ong suong nam, quan ong rong nam vai han quoc TILAA FASHION QB06",145000,145000,4.7,12,32
0,0,"Ao chong nang DAP VAN nam nu chat Umi dep, day dan - Giao hoa tiet chu ngau nhien",97000,97000,2.7,3,4
0,0,Quan Jean Nam Cao Cap Co Gian Manh 5679,104000,104000,4,10,35
0,0,Quan short Jean Nam chat xin rach phong cach dao pho,119000,119000,4.6,56,142
0,0,"Quan Tay nam Den, Quan au nam dang con han quoc, vai khong xu, nhan, loai dep",80000,80000,3.4,33,123
0,0,Quan nam Quan dui dai nam ong suong Form Slimfit dang au,49000,49000,1,1,9
59000,50,Ao phong nam nu unisex tay lo thun form rong teen co tron oversize cotton gia re basic den trang tee pull MAGMANS ,118000,59000,3.4,5,17
120000,44,"Ao Thun Nam Cotton in hoa tiet 2 mau trang den thuong hieu Julido Store, ao phong co tron basic coc tay thoang mat, tham hut mo hoi - Hang chinh hang AT02",270000,150000,4.5,26,62
0,0,Ao So Mi Nam Trang Tron TRANGBE99 (Trang Be) - M,49000,49000,0,0,63
10000,13,"Ao phong nam, ao thun nam ngan tay vai thun cotton 100% mac thoang mat - ATN001",79000,69000,4.7,6,17
574000,72,"AO PHAO NAM SIEU NHE, LOAI CO MU THAO ROI - AO PHAO NAM LOT BONG SIEU NHE ( AO LONG VU, AO KHOAC LONG VU)",800000,226000,4.5,19,49
0,0,QUAN TAY NAM CO GIAN CAO CAP DN20010510 - den - 31,85000,85000,3.8,4,32
0,0,Quan Tay Nam Den Co Gian 4 Chieu VINTAGE98 (Vintage),86000,86000,3.5,18,91
127200,44,"Quan jeans nam co dan , quan bo nam kieu tron dang vua khong bo sat thiet ke tre trung don dieu pha cach gom 5 kich thuoc (28-32) Julido mau QJNM10 - Mau xanh den",286200,159000,4.1,43,92
100000,35,"Ao thun nam co be vai ca sau, Combo 2 ao – EZ212",285000,185000,4.5,89,237
91000,71,Quan Short Thun The Thao Nam Mat Lanh Cao Cap,129000,38000,4.5,36,213
101000,48,"Ao hoodie tron mau den thoi trang tre trung, nang dong - FORMENSHOP - FM5GV016",210000,109000,4.3,62,162
0,0,Ao thun Teelab Premium Basic Tee TS063,195000,195000,4.5,10,18
0,0,Combo 5 Quan Lot Tam Giac Nam Det Kim (freesize 50-85kg) Ma S01,99000,99000,5,1,7
0,0,Ao thun tay lo Wind phong unisex form rong ALLFE nam nu cotton oversize ulzzang,79000,79000,3.9,8,11
91000,71,Quan Short The Thao Nam Co Gian Cao Cap QD021 ,129000,38000,4.2,51,142
127200,44,"Quan jean nam dep dan dau xu huong Julido, mau moi form dep ton dang khong qua om mau EQ06",286200,159000,4.5,43,90
0,0,Combo 03 Ao Thun Ba Lo Nam Novelty - Giao Mau Ngau Nhien,267000,267000,4.1,7,44
0,0,"quan sooc nam, quan dui nam chat dui sieu thoáng mát nhieu mau",39000,39000,4.6,5,6
159200,44,Quan Jean Nam Cao Cap Co Gian Manh MA41,358200,199000,4.7,35,51
0,0,Bo Do The Thao Nam Phong Cach Hip Hop - Hati - N1721,118000,118000,4.3,9,19
0,0,Quan dui ngu   nam nu chat cotton 100%,65000,65000,3.3,18,104
0,0,Ao Thun Nam Phan Quang 7 Mau Tuoi Thanh Xuan,59000,59000,4.5,61,151
0,0,Ao khoac softshell k100,550000,550000,4.8,4,16
159000,50,Ao polo nam ADINO mau trang phoi vien chim vai cotton co gian dang slimfit tre trung nang dong AP81,318000,159000,5,8,15
0,0,Ao so mi nam coc tay May 10 ma 010121174OLLT 460,156000,156000,4.2,9,23
0,0,Combo 4 quan lot nam quan sip tam giac nam duc khong duong may cao cap,319000,319000,4.3,57,317
0,0,"Ao gio Nam nu lot luoi dep, Chat lieu vai du cao cap, sieu nhe thong thoang mem mai co mu chum dau chong nang gio va bui mau moi 2021",262500,262500,5,6,11
0,0,"( video anh that)Do bo cap/ Do bo the thao loang mau unisex nam nu chat thun lanh thoang hut mo hoi thoi trang teen he, Do bo cap mac nha nam nu thun lanh in hoa tiet hoat hinh thoi trang he",109000,109000,3.8,4,13
111200,44,"Ao so mi nam lua soc caro Julido Store, xu huong moi nhat nam 2020 BZ04",250200,139000,4.7,13,35
161000,49,Ao khoac du nam 2 lop 2 mat cao cap,330000,169000,4.5,31,108
0,0,Ao thun nam nu vai cuc mat form rong,79000,79000,4.8,6,26
0,0,"Ao khoac du bomber nam cuc dep , cool , ngau , phong cach THOI TRANG MOI KINGSHOP79",95000,95000,0,0,
0,0,Quan short kaki nam vai dep,59000,59000,4.5,19,42
0,0,Quan Short Kaki Nam Lung Thun LD21,49000,49000,4.6,17,33
41000,22,"Quan short nam the thao thun lanh cao cap thoai mai, nang dong, tre trung – FORMEN SHOP – FMPS095",190000,149000,4.2,13,44
0,0,QUAN LOT ROSSO NAM DET KIM,80000,80000,4.6,19,139
0,0,"Ao Thun, Phong Nam Tap Gym Hoa Tiet Nguc Unisex Thun TheThao Form Rong Cao Cap Thuong Hieu Big Sport",108000,108000,4.5,49,107
159200,44,"Quan Jean Nam cao cap chat bo sieu co danThuong Hieu Chandi, form dung dang dep mau moi sieu hot 2021 MR9033",358200,199000,5,47,97
20000,4,Ao Khoac Nam Trung Nien 2 Lop Co Be Chat Vai Day Va Am Form Ao Vest Cao Cap,470000,450000,4.3,25,86
0,0,"Ao Thun Nam_ Nu  Phan Quang In hinh MAT QUY , ao chat, di dem, di phuot bao ngau, nhin da mat",60000,60000,4.5,35,79
0,0,Ao Thun Nam Phan Quang Thu 7 Mau Chay Ve Dau,60000,60000,4.5,56,147
0,0,Ao khoac kaki nam VONESA chat vai day cuc tot . Nhieu mau - Nhieu size tha ho lua chon ,163000,163000,5,10,62
198000,42,"Combo 3 Chiec Quan Lot Nam Tam Giac Aristino ABF064 Det Lien, Co Dan 4 Chieu (Giao Mau Ngau Nhien) - Hang Chinh Hang",477000,279000,4.5,13,43
0,0,"Sip nam am giac thun lanh cao cap,quan sip nam tam giac chat thun lanh cao cap dan 4 chieu",95000,95000,5,6,61
0,0,QUAN SHORT NGU 100% COTTON THOANG MAT QS181,39000,39000,1,2,13
0,0,"Ao ni nam da ca thu dong,giu nhiet thoi trang - Ma T41",181000,181000,4.5,13,28
209000,50,Bo The Thao Nam Chat Ni Tre Trung Nang Dong Cao Cap VICERO,418000,209000,4.8,15,47
156000,38,"Ao Thun Nam Polo Ngan Tay Co Be (5APCT013)Chinh Hang Biman by BiLuxury,Chat Lieu Cotton Cao Cap ,Thoang Mat Co Gian 4 Chieu",415000,259000,4,10,30
179550,45,Ao so mi Extra Slim Fit Shirt Blamor form om chat lieu lua cao cap hang vnxk_ASM021,399000,219450,5,5,10
0,0,Ao khoac hoodie nam nu fom rong hoa tiet ASALA,75000,75000,4.1,91,245
0,0,AO KHOAC DU NAM CHONG NUOC PHOI MAU,175000,175000,3.7,7,13
0,0,"Ao thun ba lo nam, ao basic Aristino AC-21 mau trang, chat lieu 100% cotton tham hut mo hoi cuc thoang mat, phu hop the duc, the thao, mac lot ben trong.",85000,85000,5,7,47
10000,40,Quan Sip Nam Tam Giac Chat Co Gian Thoang Mat Cap Va Mau Ngau Nhien,25000,15000,4.2,5,60
0,0,"(CO VIDEO)AO KHOAC NAM NU CADIGAN KIEU BOMBER NUT BAM PHONG CACH ,CHAT LIEU NI NGOAI NHAP CHONG NANG CACH NHIET CUC TOT HOT TREND 2021",159000,159000,3.9,9,31
79200,44,"Ao thun nam co be tay ngan tre trung, chat lieu cotton cao cap mau THUU60",178200,99000,4.6,9,32
0,0,Quan dui nam mac nha vai MAT co dan tot mac cuc ky thoai mai loai quan dui nam thong dung,12300,12300,4.1,14,159
0,0,Quan Jogger Kaki Nam Chat Mat - Ran Ri T06,68900,68900,3.4,24,68
0,0,"AO KHOAC DU NAM BOMBER NAM FORM RONG,CHAT LIEU THOANG MAT 1HIT1 FASHION",95000,95000,4,1,2
71000,47,"Ao khoac chong nang nam khoa keo cao che mat, ao chong nang nam vai kim cuong thong hoi",150000,79000,4.2,72,195
0,0,Ao khoac hoodie nam 4YOUNG phong cach Han Quoc Cau Vong,59000,59000,3.3,3,38
0,0,Ao thun nam GUMAC ATNB815 basic in chu phong cach hien dai dep thanh lich ,265000,265000,4.6,7,19
0,0,Ao so mi nam hoa tiet,99000,99000,4.1,138,1575
0,0,"Quan lot dui nam, quan sip nam co gian, mat mau dep NGAU NHIEN - OMAN- QL020",12000,12000,4.5,4,73
50000,22,"Combo 3 Quan Sip Nam Quan Lot Nam Soi Tre Mem Min Sieu Thoang Mat, Co Gian 4 Chieu  Cap Nho MRM FASHION",225000,175000,4.7,92,315
0,0,"Ao ni hoodie Essentials In cao su noi , ao ni bong unisex nam nu",123000,123000,4,3,4
124500,50,Ao Thun Nam YODY Co Tron Chat Lieu Cotton Organic - PPM4001,249000,124500,3.8,4,18
0,0,Quan jean baggy nam bo ong suong rong SR_01 HotHit 2021,135000,135000,4.3,3,7
0,0,Ao Khoac Nam UV Chong Nang Couple TX MOK 1011,649000,649000,5,11,25
0,0,Bo 5 Quan Lot Nam Nhat Thong Hoi Cao Cap (Giao Mau Ngau Nhien),99999,99999,4.5,62,151
0,0,"Ao thun Nam Nu Vonesa, ao phong Unisex Nam Nu co Size tu 25-84kg B6",40000,40000,5,8,34
0,0,"Ao thun Nam Nu One Piece Zoro, ao phong One Piece Zoro Unisex Nam Nu co Size be tu 25-84kg",40000,40000,5,7,7
0,0,"Combo 4 quan lot, quan sip dui boxer luoi thoang khi danh cho nam cao cap ( mau ngau nhien)- Le Ngoc Fashion ",125000,125000,4.5,51,155
138000,60,Ao thun nam phoi co GUMAC ABB1157,230000,92000,4.8,30,70
0,0,Ao Khoac Bomber Ni Day Dan 199x Unisex (ANH THAT),94000,94000,4.2,5,25
10000,7,Ao Sweaterr Unisex Ni Mat Cuoi 2 Mau duoi 65kg - Dang Rong G077 - Zeni69 store,135000,125000,5,5,11
0,0,Quan jean nam den tron form chat cuc dep - body (rach goi),145000,145000,4.8,20,67
0,0,"Quan short,Quan ngo nam vai dui mem min thoang mat",49000,49000,0,0,16
0,0,( Anh that ) COMBO 05 Quan dui nam chat mem mat (mau caro < 80kg ),102660,102660,5,2,6
108000,44,"Ao khoac nam JJ04 VANG , khoac du nam 2 lop phoi non khong thao roi thoi trang han quoc tre trung cuon hut Julido mau TT02 chat lieu tham hut mo hoi day dan mac thoang mat",243000,135000,4.2,54,134
127200,44,"Quan jean nam chat jean xin Julido, Phoi rach mau moi form dep ton dang khong qua om mau MM01",286200,159000,4.2,154,434
159200,44,"Quan Jean Nam cao cap co dan 4 chieu Thuong Hieu Chandi, phong cach han quoc tre trung ca tinh MR9013",358200,199000,4.8,38,107
111000,44,Quan Jogger Kaki Nam Phong Cach Tre Trung Nang Dong Thoi Trang VICERO,250000,139000,4.3,40,113
0,0,"Ao khoac du bomber logo in Black Miack dep, tay phoi mau tre trung ca tinh,Ao khoac bomber tay phoi cam in logo ulzzang",105000,105000,3.7,7,19
0,0," Ao khoac du nam nu mac in noi , ao khoac du nam , ao khoac du nu , ao khoac gio ,ao khoac du , ao khoac nam kieu bomber vai du ngoai 2 lop",71000,71000,4.6,5,10
71000,36,Ao So Mi Nam Ke Caro Co Be Dai Tay Phong Cach Han Quoc,200000,129000,4,144,1145
0,0,Ao Hoodie Nam Nu Unisex  ROUGH Chat Ni Bong Form Basic Phong Cach Han Quoc 5 Mau Tre Trung,169000,169000,4.7,14,34
150000,50,Ao Ni Thu Dong Cho Nam 8 Mau VICERO,300000,150000,4.5,50,140
0,0,Ao Thun Nam Trang Tron THUNTRANG01,101000,101000,0,0,1
80000,21,Ao Polo YODY Nam Cafe Phoi Nep Tre Trung Chong Tia UV Huu Hieu - APM3635,379000,299000,4.8,35,85
0,0,Ao Khoac Free Fire [ Tang 1 Non Heavy ] Chat Ni Mau Vang Team Heavy Cuc Dep Kieu Dang Hoodie Tre Trung De Phoi Do Phu Hop Cho Ca Nam Va Nu,169000,169000,4.5,86,227
0,0,quan short nam - Quan dui nam mac nha cho nguoi 45-85kg co gian mat me,45500,45500,5,3,11
0,0,"(HANG XIN) Combo 3 mau (KEM HOP)_Ao ba lo Nam 100% cotton co gian 4 chieu, thoang mat khong bai xu_Ao thun Nam, Ao phong Nam",189500,189500,4.3,9,30
91000,36,"COMBO 3 Quan lot nam dang Boxer, chat vai bambo cao cap mem min thoang mat QL13",250000,159000,4.8,20,65
0,0,COMBO 4 QUAN SIP NAM TAM GIAC LO NHO CHAT MAT LANH CO GIAN 4 CHIEU THONG HOI KHANG KHUAN,74500,74500,4.3,4,9
0,0,Combo 2 Quan Dui Nam Loai Caro Nho Vai Mem Mat Freesize Duoi 65kg,29000,29000,4.3,3,16
0,0,SWE - Ao thun den nam in da quang phan quang trong toi chup flash FREESIZE,129000,129000,5,63,141
0,0,{SIEU PHAM MUA DONG} AO KHOAC NAM /AO KHOAC NAM NI NGOAI LOT LONG GIU NHIET SIEU AM AP CHO MUA DONG CO SIZE 3XL ,169000,169000,3.9,12,36
0,0,"Ao khoac bomber du unisex bong chay form rong Meo Lau nam nu ulzzang, Ao khoac du kieu bomber 2 lop theu logo ca tinh thoi trang, Ao Khoac Bomber Du Unisex Bong Chay Form Rong Meo Lau Nam Nu Ulzzang KiuKiu, Ao Khoac Bomber Chat Lieu Kaki Chat Dep",97000,97000,3.8,5,16
0,0,"Do bo nam nu mac nha dao pho chat thun lanh in dau soi Clothing de thuong, ca tinh nang dong form chuan,Bo do mac nha unisex dang the thao chat thun lanh mac he sieu mat,",100000,100000,3.3,3,6
0,0,AO KHOAC BOMBER NAM HOA TIET CHU G 2 LOP VAI MERO HANG CAO CAP CHONG NHAN THEU 100% SIEU NGAU 2021 HOT,139000,139000,4.6,25,42
111200,44,Ao khoac nam chat kaki 2 lop xin xo Julido Store mau moi theo xu huong thoi trang Trend002,250200,139000,3.8,37,101
0,0,ao so mi nam dai tay x9,252000,252000,5,9,14
0,0,Soi - Ao thun den nam in da quang phan quang trong toi chup flash FREESIZE,99000,99000,4.8,13,32
0,0,Quan baggy nam cap chun ong con chat dui nhièu màu mạc thoáng mát,82000,82000,4.2,10,19
0,0,QUAN SOT KAKI NAM NHIEU MAU,48500,48500,4.2,14,149
0,0,Quan Jogger Den/Trang Hoa Tiet Hoat Hinh Ulzzang Nam Nu 1hit_Unisex,97000,97000,5,1,1
0,0,AO KHOAC HOODIE NAM BONG CHAY LA THOI TRANG HAN CA TINH SIEU SANH DIEU,0,99000,3.8,15,
0,0,Ao Khoac Cadigan Kieu Boomber Ni Ngoai. Ao Khoac Danh Cho Nam Phong Cach Han Quoc,101000,101000,3.4,7,18
0,0,"Quan jogger nam chat vai kaki co gian 4 chieu , bo chun ong chan ca tinh tre trung, dang om body thoi trang, freesize tu 45-76kg, nhieu mau lua chon",49000,49000,0,0,2
0,0, Quan Baggy Nam Nu KAKI Ong Suong Unisex - BG01 - SP1,79000,79000,4.5,8,18
0,0,"Quan Lot dui Nam, quan sip dui nam thun lanh TOM cao cap, sang trong, co gian",95000,95000,5,6,44
0,0,Ao Khoac Du Nam Unisex Han Quoc KD2B7,82000,82000,4.1,36,187
0,0,Ao phao nam nu sieu nhe sieu am AK37,303000,303000,1,1,1
0,0,Quan JOGGER Thun Poly The Thao Thoi Trang Nam 2021,175000,175000,3.5,21,85
42000,49,Ao giu nhiet nam lot ni co 3 phan hang loai 1 sieu am,86000,44000,4.2,9,46
224500,50, Ao so mi nam Novelty ngan tay 170290N vat ngang ,449000,224500,4.5,8,20
168000,60,Ao thun nam bo co phoi tui GUMMAC lich lam ATNB480,280000,112000,5,5,13
0,0, COMBO 4 Quan sip dui quan lot nam thun lanh lua sua xu duc cao cap,137000,137000,4.6,22,61
0,0, Quan dui nam loai caro nho chat vai mem min free size duoi 65kg,29000,29000,3.8,4,32
0,0,Ao So  Mi Nam Form Rong Phong Cach Han Quoc Chat Lieu Mem Min Thoang Mat SMLV18,79000,79000,4.5,81,204
0,0,Quan kaki nam big size tren 90kg vai kaki day dep mac mat may ky chac chan hang chuan xuat khau,119000,119000,4.6,64,113
220000,47,"Ao Thun Nam Polo Ngan Tay Co Be Chinh Hang Biman by BiLuxury (5APCT012),Chat Polyester Cao Cap, Theu Co Lich Lam,Tre Trung, Nang Dong",469000,249000,4.2,18,47
159600,40,Ao so mi Slim Fit Shirt Blamor form om chat lieu lua cao cap hang vnxk_ASM048,399000,239400,5,13,25
106000,42,Ao Khoac Nam Big Size Ao Khoac Du Day Nam Tron Hai Lop Chong Lanh Chong Nang Chong Gio Cao Cap QD34 - ShopN6 (Nhieu Mau),255000,149000,4.7,33,69
0,0,Ao Polo Nam Co Co Vai Ca Sau Nhieu Mau,49000,49000,4.5,32,91
0,0,ComBo 2 Cai Quan Dai Jogger Nam Thun Cao Cap Thoi Trang - TC04023,179000,179000,1,3,11
103200,44,"Ao Thun Nam Ngan Tay Chandi, Chat Thun Cotton Xin Mau Moi NT20",232200,129000,4.6,30,57
0,0,Ao gile tran thu vai bo ben dep,299000,299000,4.8,4,14
0,0,"Quan jogger nam , quan dai nam, quan nam , quan kaki nam , quan nam 4 khoa chat kaki day min ko xu ko nhan",95000,95000,0,0,
0,0,"Ao thun nam thoat nhiet Nhat Ban GOKING sieu thoang mat, ao phong nam cao cap tham hut mo hoi, mac nhu khong mac",159000,159000,4.6,215,1408
0,0,"QUAN JEANS JOGGER, QUAN BO NAM TRON PHONG CACH GIAN DI, DE PHOI DO",315000,315000,5,18,27
61000,23,Quan kaki nam ngan short kaki ben bi thoi trang co gian TKPSK03 PigoFashion chon nhieu mau,260000,199000,5,17,39
49500,33,Ao HOODIE POKA Unisex - K79,148500,99000,4.5,40,83
0,0,"Ao giu nhiet lot ni cho NAM co 3 phan sieu mem, sieu am",80000,80000,4,1,2
0,0,Ao so mi nam abd,95000,95000,4.2,38,169
190000,48,"Ao Thun Nam Polo Ngan Tay Co Be (5APCB007) Chinh Hang BiMan By BiLuxury ,Kieu Dang Body Fit Lich Lam, Nhieu Mau Sac Tre Trung, Nang Dong",399000,209000,4.8,36,89
0,0,"Quan au nam cao cap , dang slimfit, chuan thiet ke, cuc ton dang, lich su, tre trung",89000,89000,0,0,
165000,47,Quan Kaki Dang Au Nam Thoi Trang Thanh Lich 4 Mau Thoi Thuong ZERO,350000,185000,4.1,17,41
0,0,"Ao One Piece Luffy ATT-02, Ao thun Anime Manga One Piece Monkey D. Luffy Unisex Nam Nu",49000,49000,4.6,68,158
0,0,Quan the thao nam TinoFun ma TT57 the duc jogger kieu thun tron bo ong dep dai co gian mua he thu,93000,93000,4.3,10,30
55000,37,"Do bo the thao chat thun lanh ETINONUC, Set The thao nam nu, Do bo the thao mac nha etinonuc, Do bo mac nha chat thun lanh ca tinh, BO QUAN AO THE THAO BO DO NAM NU SIZE M L CHAT THUN LANH, BO QUAN AO THE THAO BO DO MAC NHA / DO BO NAM NU / BO DO NAM NU",150000,95000,4.7,12,32
0,0,Quan Dui Nam Ke Soc Loai Dep Vai Mem Mat Thoang Khi Size Lon 55-85kg,19000,19000,4.5,11,68
59000,50,Ao phong nam nu unisex tay lo thun form rong teen co tron oversize cotton gia re basic den trang tee pull freesize MEO MY TOM ,118000,59000,4.5,4,9
59000,50,Ao thun nam tay ngan co tron body streetwear phong unisex basic tee cotton teen oversize den trang gia re SMIPLEST,118000,59000,4,10,38
0,0,"Ao thun nam tron Gold Rhino cao cap, 2 mau Trang / Den, hang xuat khau Nhat Ban, 100% cotton chat xin, ao phong nam tron mem min, tham hut mo hoi, khang khuan, khu mui hoi triet de - Hang chinh hang",199000,199000,4.7,54,163
0,0,Ao thun nam tay ngan AKUBA form freesize chat lieu cotton khong co rut AB2032,65000,65000,4.8,15,65
0,0,Ao Khoac Nam Cao Cap 2020 - Ao Khoac Nam Mu Long Day Am Ap,489000,489000,4.5,18,41
46000,37,[ Co Anh That ] Ao thun unisex tay lo form rong - phong phoi tay CALI,125000,79000,4.8,88,194
0,0,"Quan Short Gio Nam  (4 mau) Vai Mem, Sieu Nhe, Dang The Thao",39000,39000,0,0,5
0,0,"Ao Thun Nam Phan Quang In CO HAI TAC BANG RAU TRANG, anime ONE PIECE , ao chat, di dem, di phuot bao ngau, nhin da mat",59000,59000,4.7,55,126
0,0,Quan kaki nam trung nien cong so dang chuan ben dep Nau nhat Xam den,135000,135000,4,11,40
0,0,"Xet quan ao squid game Miuzi,Bo quan ao tro choi con muc kem ao Phong ben Trong",79000,79000,3.9,7,18
0,0,Ao so mi nam dai tay X22,252000,252000,5,7,10
125000,42,Combo 2 Quan shorts the thao nam dang sot sport dui chat thun lanh 4 chieu cao cap phu hop tap gym hay mac nha mau trang va den DUI-P101,299000,174000,4.2,145,784
96000,44,"Ao thun nam dai tay Julido, Chat thun cotton xin bo tay va hong mau thu dong X6666",216000,120000,4,6,13
80000,44,"Ao thun nam co be tay ngan tre trung, chat lieu cotton cao cap mau THUU46",180000,100000,4.8,16,37
0,0,Ao Thun Tay Lo Unisex NIGHTMARE TEE 100% Cotton - HADES Brand Chinh Hang,420000,420000,4.7,3,4
0,0,Ao So Mi Nam Dai Tay Vai Lua Chong Nhan,99000,99000,4.3,35,88
0,0,Quan lót nam kiẻu quàn dui thun Voga vải thun cotton thoang mat,79000,79000,5,9,102
0,0,"Bo the thao nam nu thu dong chat Umi day dan, giu nhiet tot, co ao bomber thoi trang",189000,189000,4,6,12
0,0,Ao So Mi Nam Phoi Caro Phong Cach Tre Trung,95000,95000,4.5,38,100
0,0,"Do bo the thao nam Cotton xop Thai tap gym,mac o nha di choi cuc thoang mat, tham hut mo hoi tot thoi trang MINHSTORE",139000,139000,4.5,6,18
0,0,Quan short nam kaki den tron vai mem vai dep loai quan kaki han quoc,79000,79000,3.9,19,49
0,0,Ao khoac du nam ASALA AK135,95000,95000,4.2,10,87
0,0,Ao Khoac Du Nam Hai Lop Thoi Trang Cao Cap PONIVA Chat Lieu Thoang Mat Cuc Dep,125000,125000,4.8,4,9
111200,44,"Ao Khoac Nam cao cap Julido Store, chat du 2 lop mau moi duoc yeu thich NK01",250200,139000,4.5,40,98
159000,53,Quan Short Nam Kaki Vicero 6 Mau Phong Cach Han Quoc,298000,139000,4.2,10,30
135000,45,"Quan jogger nam tui hop K41 chat kaki mem min, phong cach duong pho",300000,165000,4.5,8,17
0,0,AO KHOAC NAM CUC AM CHO MUA DONG XIN XO,275000,275000,2.3,7,23
0,0,Ao So Mi Tron - Ma SM-001,69000,69000,4.5,28,64
126000,51,"Ao Phong Nam Biluxury  (5APKH009XDU) Chat Vai Cotton, Spandex Cao Cap, Kieu Dang  Tre Trung Lich Lam, Co Gian 4 Chieu, Chong Nhan,Thoang Mat",245000,119000,4,8,34
0,0,Quan Kaki Nam Kieu Dang Han Quoc Tre Trung Ong Con Cuc De Phoi Do,80000,80000,5,1,5
0,0,"Ao hoodie nam , ao hoodie nu , ao khoac ao hoodie cap doi nam nu mac",98000,98000,4.3,9,25
197100,45,Ao Thun Nam Khatoco A2MN438R2-VNMK006-2012-N - Xanh Ngoc,438000,240900,5,9,20
0,0,"Ao Khoac Nam Chat Gio Pmax (3 mau), Co 2 Lop, Co Mu, Dang Tre Trung, Chong Tham Nuoc, Chong Gio, Thich Hop Nam Nu",169000,169000,4.7,15,20
0,0,Ao So Mi Nam Phoi Caro Khong Len Lai Nam Tinh,125000,125000,4,118,303
236000,48,Quan tay nam Novelty 1Ply NQTMMDMT3C1806951 xanh den,495000,259000,4.8,8,32
0,0,quan jean dai nam xanh bac cao nhe - B5678,99000,99000,3.8,28,113
80000,45,"Ao so mi nam tron khong nhan LADOS - 523, Chat vai mem mat, tham hut mo hoi tot, form slimfit",179000,99000,5,20,53
0,0,Quan Short Thun Nam Mac Mat,19000,19000,4.6,21,179
0,0,ao so mi nam tay dai chat vai lua it nhan mau moi 2020 chu in,89000,89000,4.5,73,291
0,0,"(anh that, co san) ao khoac ni hoodie unisex bape ca map",250000,250000,4.2,10,39
421000,60,"AO KHOAC NAM, AO KHOAC PHAO SIEU NHE, SIEU AM - MA 01 TH( AO LONG VU, AO KHOAC LONG VU )",700000,279000,4.7,14,33
188000,56,Ao Thun Nam Co Co Tay Ngan Polo 6 Mau Thoi Trang VICERO,338000,150000,4.2,37,108
0,0, Ao Hero Team Mini World ,40000,40000,5,3,5
42000,20,Quan Lot Nam Jockey Dang Trunk Seam Free Mem Mai - JMMB9118-10,210000,168000,4.5,19,94
96000,50,Do bo nam nu chat vai thun lanh in chuyen nhiet co gian 4 chieu (conon),192000,96000,3.6,16,51
87000,47, Quan Lot Nam Jockey Tam Giac Ban To Thun Cotton Bamboo - JUMB0419,185000,98000,3.6,5,34
0,0,Ao thun nam nu Vonesa thoi trang cuc chat cotton mem min ca tinh du size 25-84 kg a2,23000,23000,5,3,3
117000,41,Quan Lot Nam Jockey Tam Giac Hoa Tiet Thun Lanh Khang Khuan Do In - J1162,285000,168000,5,4,14
0,0,Quan Bo Nam Phong Cach Tre Trung JEAN53 - Jean,99000,99000,4.5,16,45
112500,50,Set 3 Quan Lot Nam 5S (5BX020-01) Chat Lieu Cotton Cao Cap,225000,112500,4.6,41,140
0,0,Quan bo thung tui cheo,149000,149000,2.7,54,138
59000,50,Ao phong tay lo form rong unisex nam nu thun teen co tron oversize cotton gia re basic den trang tee pull GKKRT,118000,59000,4.7,11,27
194500,50,"Ao Thun Nam Co Co 5S (3 mau) Tay Ngan, Chat Lieu Thun Cotton Premium Co Gian, Tham Hut Mo Hoi (APC21004)",389000,194500,4.7,19,49
0,0,Quan Tay Nam Vai Tuyet Mua DEN98 (Den) - 29,85000,85000,4,4,29
0,0,"Ao Gio 2 Mat Pmax, 2 Lop, Mac Cho Ca Nam Nu, Chong Nuoc, Chong Gio, Chong Nang, Phom Tre Trung",229000,229000,4.8,37,59
0,0,[ Anh That ] Ao Khoac Du Gio Bomber Bong Chay Blacka Form Rong Unisex Nam Nu Mac Cap Doi - Bomber Jakets Ao Khoac Thien Ha,88000,88000,4.3,3,3
0,0,Quan Au Kaki Nam Dang Thoi Trang Tre Trung Cao Cap Bateno KN11,116900,116900,4.5,5,34
154000,43,Combo 3 quan lot nam trunk iBasic PANM078,357000,203000,5,23,145
297000,50,Quan jean nam GUMAC QJNB6106,595000,298000,5,8,27
0,0,Ao thun tay lo form rong theu chu BASIC - Unisex nam nu deu mac duoc,79000,79000,4,3,7
169000,42,Ao Hoodie Nam Co Mu (4ANOT012VAB) Chat Ni Cao Cap Day Dan Khong Bai Xu Hang Cao Cap Chinh Hang  Biman By Biluxury,398000,229000,5,8,12
0,0,"Quan Boi Nam Boxer Co Tui CLEACCO DEENYT Chat Lieu Nylon Cao Cap , Chong Tham , Nhanh Kho Form Fitness Thoi Trang (Tang kem non boi + bit tai silicon) - Hang Chinh Hang",249000,249000,4.7,45,138
0,0,"Ao gile len nam AKUBA form regular, chat lieu len det kim 029057",489000,489000,4.5,20,55
135000,45,Bo Mac Nha The Thao Nam Thun He Cao Cap ZERO,300000,165000,4.5,32,87
0,0,"Ao hoodie nam nu Stick in hinh sinh doc dao, form rong han quoc, chat ni mem nhe",69000,69000,4.2,40,184
92000,32,Ao thun nam ngan tay co tron dep chat vai cotton co gian 4 chieu thoang mat ZAVAS  Z02,289000,197000,5,19,40
0,0,Quan boi nam vay da ca the thao chuyen nghiep YOUYOU,109560,109560,4.8,69,184
0,0,Ao khoac hoodie nam nu unisex phong rong ASALA (HD-11),99000,99000,4.1,62,357
127200,44,"Quan Jean Nam co dan 4 chieu thuong hieu Julido Store, mau moi 2021 QJ608",286200,159000,4.6,41,67
0,0,SET BO QUAN AO DAI THU DONG VAI DU,299000,299000,4.6,5,5
0,0,combo 3 quan dui nam trung nien vai kate thai sieu mat va ben duoi 85kg,165000,165000,3.8,6,18
144000,44,"Quan Short Jean Nam co dan kieu dang tre trung don gian Thuong Hieu Chandi, quan sot mau moi xu huong 2021 QSJN300",324000,180000,4.7,13,23
0,0,"Ao khoac jean nam cao cap khong phai khong xu, ao khoac bo thiet ke tre trung nang dong AK06",179800,179800,3.1,8,17
0,0,"COMBO 4 QUAN LOT NAM Cao Cap, Khang Khuan Ngan Mui Hoi Mem Thoang Mat",250000,250000,3.8,163,1766
144000,44,"Quan Short Jean Nam co dan kieu dang tre trung don gian Thuong Hieu Chandi, quan sot mau moi xu huong 2021 QSJN224",324000,180000,4.5,22,48
96000,36,Combo 10 Quan lot nam tam giac cotton xin nhieu lung co size lon mau ngau nhien cao cap mac cuc thoai mai underwear SIP HN10 ,269000,173000,4.8,44,166
159200,44,"Quan Jean Nam sieu cap thuong hieu Chandi,  chat jean co dan mau moi 2021 ma HD89",358200,199000,4.8,32,42
16000,8,"Ao Thun nam cá sáu mãu mói, combo 2 áo - DBM215",213000,197000,4.5,58,88
0,0,Quan Lot Nam- Sip Cotton Cap To Mem Mai Thoang Khi K465,55000,55000,4.8,64,193
0,0, QUAN LOT TAM GIAC NAM QB983,95000,95000,4.8,8,18
0,0,"Ao thun ba lo in WELLA thoi trang, Ao thun ba lo cotton, Ao Thun Ba Lo nam Nu Cao Cap, Ao thun 3 lo",70000,70000,4.3,6,11
20000,17,"Ao Thun Nam Co Be Doka 4 Chieu Cao Cap, Tre Trung (Nhieu Mau)",119000,99000,4.6,33,83
0,0,Ao Free Fire [ Tang 1 Non Theu Heavy ] In 3D Mau Den Team Heavy Cuc Chat Hot Trend 2020 Chat Lieu Mem Min Phu Hop Cho Ca Nam Va Nu,99000,99000,4.3,51,145
101000,40,AO KHOAC DU NAM CHONG NANG HAHAMAN CO NON LOT LUOI PHOI MAU CAO CAP AKN01020,250000,149000,4.8,31,49
79200,44,"Ao thun nam the thao tay lo, co tron dep, tre trung, mac thoang mat, tham hut tot CHANDI HH10",178200,99000,4.5,16,59
79200,44,"Ao thun nam co tron tay ngan tre trung, chat lieu cotton cao cap mau THUU15",178200,99000,4.7,15,32
61000,36,Quan short nam tay au Kojiba vai co gian nhe  dang om quan ngo nam cong so lich su phu hop dao pho du lich,170000,109000,4.3,158,429
26000,21, Ao thun tay dai form rong unisex - ao sweater Naliee,125000,99000,4.6,10,20
0,0,Ao len co lo - ao len nam co lo thoi trang - ao len co cao danh cho ca nam va nu,69000,69000,4,3,10
159200,44,"Quan Bo Nam cao cap  thuong hieu Chandi, chat jean co dan Hot Trend 2021 ma MR9039",358200,199000,5,33,56
0,0,Ao Thun Nam Ao Thun Nam Co Co Tay Ngan Phoi Vien Ngang Trang Den Xam Thoi Thuong,125000,125000,3.3,4,7
200000,44,"Ao Khoac Nam Du 2 lop Xin co tui trong khoa keo tui ngoai, Ao khoac Nam trang tron thuong hieu Julido Store KFF01",450000,250000,4.6,25,144
0,0,"Set do bo nam in hinh Naruto sieu dep, Set Do The Thao Ao Thun Tay Ngan In Hinh uzumaki Thoi Trang, Nguyen bo quan ao nam Uzumaki cuc hot, bo mac nha, quan ao the thao nam, do bo the thao mac nha nam, BO QUAN AO THE THAO MAC NHA, THOI TRANG NAM NU, BO DO NAM / BO DO NU / BO QUAN AO NAM /BO QUAN AO THE THAO BO DO NAM NU",95000,95000,4.5,51,137
10000,6,Ao Khoac Nam Tron Co Mu,179000,169000,4.1,86,306
95520,48,"Ao Thun Phong Nam Ngan Tay Co Tron Tron Basic  Phom Rong  Oversized Phong Cach, Tre Trung TUTO5 AT1001",199000,103480,4.8,201,1828
297000,50,Quan jean co ban GUMAC QJNB6114,595000,298000,5,5,10
0,0, Quan Dui Nam Theu Hinh Nai Size tu 50 - 85kg,49000,49000,4,4,31
159600,40,Ao so mi Slim Fit Shirt Blamor form om chat lieu lua cao cap hang vnxk_ASM055,399000,239400,5,21,38
151000,36,Ao Khoac Da Nam Den Lot Long Cao Cap AKD22,420000,269000,4.5,105,291
0,0,"VARDINO ao khoac nam cao cap co be - co dung, tron - hoa tiet, mem - min - nhe - khong nhan - khong phai - chong nuoc chinh hang dang xuong - om vua - vat bang cong so trung nien moi ak05",895000,895000,4.5,11,29
209000,50,Bo Ni The Thao Nam Thuong Hieu Thoi Trang VICERO,418000,209000,4.3,48,96
103000,37,"Combo 4 Quan sip nam, quan boxer nam chat cotton thun cao cap ZBra - ZQN16 (Mau ngau nhien)",282000,179000,4.5,27,97
128000,37,"Ao So Mi Nam Ngan Tay Mau Trang (4SMCH007TRT) Hang Chinh Hang Biman by Biluxury ,Hoa Tiet Tre Trung,Thanh Lich, Chat Lieu Cao Cap Thoang Mat,Mem Min",349000,221000,5,4,10
0,0,"Quan dui nam mac ngu King168, Chat dui chinh pham mac mat mau TOP3",39000,39000,1,1,9
0,0,Ao ni da ca nam dai tay T41,176000,176000,4.8,10,14
128000,37,"Ao So Mi Nam Ngan Tay  Hoa Tiet ( 4SMCH011TRT)Hang Chinh Hang Biman by Biluxury Phom  Bodyfit  Tre Trung,Thanh Lich, Vai Cotton Cao Cap Thoang Mat,Mem Min",349000,221000,4.7,9,18
20000,13,Ao so mi nam co tru chui dau dai tay,149000,129000,4.7,11,83
0,0,"Ao khoac Nam, Ao Blazer Nam phong cach Han Quoc BZ01",299000,299000,4.6,9,30
161000,34,Ao khoac du nam AKUBA Cao cap 2 lop | 01CW011,469000,308000,4.2,5,15
0,0,Quan Kaki Nam Kieu Dang Han Quoc Ong Con Phong Cach The Thao,80000,80000,5,1,9
0,0,Quan dui shorts 2in1 bo dui trong Pmax mau hot hit,129000,129000,4.8,19,43
0,0,[Co gian-Mem mai-Thong thoang] Combo 05 quan lot dui nam boxer Nhat MUNAFIE khang khuan co tui ZIP sang trong,129000,129000,0,0,
0,0,AO THUN NAM NGAN TAY CO BE MAU MOI,78000,78000,4.3,75,306
0,0,Quan Jean Nam Mau Den Rach Goi Co Dan Phong Cach Thoi Trang ms59,97000,97000,3.9,12,58
0,0,Bo ni nam co tron 3 vach - Bo do nam mac nha dai tay chat ni day dan - BD54,139000,139000,3.7,9,14
0,0,Ao Ba Lo Nam Thun Cotton - Ao sat nach nam tanktop dang the thao mac nha chat cotton mem thoai mai,45000,45000,4.5,20,97
159200,44,Ao Thun Polo Nam Co Be Tay Ngan Phoi 3 Mau Chu Dao Thoi Trang Men Luxury PL4,358200,199000,4,4,12
0,0,Ao Khoac Du 2 Mat Unisex Truot Nuoc Lavic 2015,199000,199000,4.2,12,33
0,0,"Set Ao Hoodie unisex Quan Jogger ️ Ao khoac ni thu dong SKICEN + ETADET quan ong, form unisex nam nu tre trung",94000,94000,4.2,6,28
0,0,Ao so mi nam dai tay mau trang khong tui vai mem min khong nhan,61000,61000,4.5,49,163
102090,41,Ao Thun Nam Tay Lo Unisex co Tron chat lieu vai cotton mau trang form rong in chu NAREY quanh co phong cach doc chat TheNgaustyle,249000,146910,4.6,64,147
159200,44,"Quan Jean Nam dep dan dau xu huong Thuong Hieu Chandi , mau moi form dep ton dang mau hot nhat 2021 MR9047",358200,199000,4.6,43,85
0,0,"Quan Jean, Baggy bo nam, tui hop 2 mau den xanh, ong xuong,rong ma TH-01 style han quoc",0,169000,3,4,
0,0,Ao thun giu nhiet nam cao co phong cach tre trung nang dong,100000,100000,0,0,4
0,0,"Ao thun Nam Nu Vonesa, ao phong Unisex Nam Nu co Size tu 25-84kg B13",40000,40000,5,5,5
0,0,Ao So Mi Trang Nam Hoa Tiet Ben Vai Phai,88000,88000,4.5,57,288
0,0,"Ao thun Nam Nu Vonesa, ao phong Unisex Nam Nu co Size tu 25-84kg B11",40000,40000,5,8,11
103200,44,"Ao Thun Nam Ngan Tay Chandi, Chat Thun Cotton Xin Mau Moi NT18",232200,129000,4.8,32,126
142000,50,Ao thun polo nam GUMAC ATNB704 phoi tui phom dang lich lam,285000,143000,4.7,28,68
144000,60,Ao thun nam GUMAC ATNB596 tay ngan in chu,240000,96000,5,6,29
109000,25,"Ao khoac nam, ao phao long vu sieu nhe, sieu am, chong nuoc ATUNER QLN026, ao khoac phao nam nu kieu dang unisex nang dong, tre trung – HANG CHINH HANG",429000,320000,4.8,25,37
0,0,Quan kaki tui hop nam cao cap ,235000,235000,4.1,33,57
91000,32,"Ao thun nam co be vai ca sau, Combo 2 ao – EZ235",285000,194000,4.3,224,476
150000,27,"Ao Khoac Gio 3C YODY Nam The Thao Sup Suon, Can Gio, Can Bui, Chong Tham - AKM4029",549000,399000,4.8,25,43
0,0,Quan Short Kaki Nam Vai Dep( co anh that),59000,59000,3.5,29,73
0,0,"Quan Dui Nam Chat Vai Cotton Thoang Mat,Quan Short Nam 5 Mau Form Dang Cuc Dep",39000,39000,2.7,7,21
36000,42,"Quan Sip Dui Nam 5S (5BX020) Chat Lieu Cotton Cao Cap, Mem Min Thoang Mat",85000,49000,5,39,191
147000,41,Ao Thun nam cá sáu mãu mói -DB2QC06,359000,212000,4.3,4,19
185000,50,Quan Au Nam Phong Cach Cong So Lich Lam,370000,185000,4.5,63,238
0,0,"Quan Kaki Nam Basic ROUGH Chat Day Dan, Co Gian Outfit",195000,195000,4.7,11,56
0,0,Quan Bo Nam Den Tron Dang Skinny Phong Cach Don Gian Tre Trung SQ602A,149000,149000,4.6,49,122
115000,38,Ao khoac jean nam HAHAMAN thoi trang cao cap AKJ010,300000,185000,4.8,15,12
0,0,Quan short thun unisex Wind form rong bong chay Chu V lung nam nu oversize ulzzang,89000,89000,4.7,3,6
0,0,Quan dui nam chat dui mau sac thoi thuong hot trend sieu mat danh bay cai nong ( Ma T36),135000,135000,4.6,14,47
0,0,"Ao khoac ao chong nang nam, chat vai umi min dap van noi 2021",126200,126200,5,6,8
0,0,Bo The Thao Nam Chat Ni Da Ca ROUGH,199000,199000,4.1,31,57
0,0,"ao nam - chat lieu da ca, kieu dang sieu tre trung (D6)",165000,165000,5,11,29
10170,3,Ao phao sieu nhe day dan giu nhiet tot ,339000,328830,3.7,6,9
0,0,"Bo 4 Quan Lot Boxer Nam Cotton Cao Cap, Quan Sip Dui Nam Hoa Tiet Ke Don Gian De Phoi Do QA - 389",159000,159000,5,6,16
0,0,"Ao Khoac Nam Chat Gio Pmax, Co 2 Lop, Co Mu, Dang Tre Trung, Chong Tham Nuoc, Chong Gio, Thich Hop Nam Nu",167500,167500,4.7,26,44
0,0,"Ao thun nam nu tay lo form rong, phong cach Han Quoc ATL246",69000,69000,4.7,9,16
0,0,AO SO MI LUA NAM BODY CUC DEP THOI TRANG PHONG CACH HOA NAM THAN NAM MOI,98000,98000,3.9,7,21
21500,19, quan nam dài chat dui mem mai,110500,89000,4.8,24,61
0,0,"Ao thun nam co be phoi vien vai, theu kim tuyen truoc nguc hang cao cap, chat thun mem mat ",79000,79000,4.3,42,127
159200,44,"Quan Jean Nam dep dan dau xu huong Thuong Hieu Chandi , mau moi form dep ton dang khong qua om MR9044",358200,199000,4.7,38,104
0,0,Ao vest nam Han Quoc gia chi 289K - DUKI STORE,289000,289000,4.3,10,24
0,0,"Ao khoac du nam nu, ao khoac bomber unisex in chu BALCK phoi vien cuc dep thich hop di choi di dao",93000,93000,4.2,5,8
0,0,"Quan Jean Nam, Mau Moi, Phong Cach Thoi Trang Cao Cap ms176",130000,130000,4.3,9,19
159600,40,Ao so mi Slim Fit Shirt Blamor form om chat lieu lua cao cap hang vnxk_ASM034,399000,239400,5,21,33
508000,30,Ao Khoac nam New Balance - AMJ11242BK (form Chau A),1695000,1187000,5,5,13
92000,32,Ao Phong T - Shirt Nam Jockey Thun Cotton Compact In Haft Boy Cao Cap - J7338,290000,198000,5,8,23
115000,50,Ao so mi in hinh cay dua GUMAC ANB6110,230000,115000,5,10,25
0,0,Ao khoac varsity HADES - GLORY ROAD,1300000,1300000,5,3,7
157000,35,Quan Short Nam Jockey From Rong Thun Cotton - JUMP0424,445000,288000,4.7,7,27
93600,50,Do bo nam nu chat vai thun lanh in chuyen nhiet co gian 4 chieu (matgau),187200,93600,4.5,10,23
0,0,Ao Thun Polo hang xuat khau form Quoc te bigsize hang cao cap Bao Bao Store,79000,79000,4.6,42,127
0,0,Ao khoac kaki jean Nam UNISEX - 6 mau can ban ,59000,59000,4.5,164,392
0,0,"Ao Chong Nang 2 Mat, 2 Lop Pmax Day Dan, Chong Nang, Chong Tia UV, Phu Hop Nam Nu",137000,137000,4.6,64,118
159000,50,Ao polo nam ADINO mau xanh nhat phoi vien chim vai cotton co gian dang slimfit tre trung nang dong AP82,318000,159000,5,7,14
111200,44,"Ao khoac nam Julido, thoi trang tre trung 2 lop lot du co tui va day rut hong mau JL01",250200,139000,3.9,30,99
0,0,"Combo 5 quan lot nam cotton, quan sip nam tam giac gia re voi lung thun co gian thoai mai, vai tham hut mo hoi",150000,150000,4.8,14,25
0,0,Quan Jean Nam- co gian-CAO CAP-thoi tran Phong Cach Han Quoc -00-J4B,138000,138000,4.1,61,172
0,0,"Quan jean baggy Vonesa nam nu ong rong , dang xuong , khong phai mau Q1",149000,149000,5,8,12
0,0,"Combo 4 quan lot, quan sip cheo luoi thoang khi danh cho nam cao cap ( mau ngau nhien)- Le Ngoc Fashion",125000,125000,4.8,33,83
0,0,"Ao khoac bomber , Ao khoac nhung nam , ao khoac nhung nu , ao khoac bomber nhung , ao  khoac cap doi vai nhung logo theu",120000,120000,5,1,3
0,0,Bo Quan Ao Nam Ao Thun Nam Tay Lo In Chu X Quan Short Nam Phoi Soc Trang Zenkonu TOP NAM 1000164 + SHORT NAM 1000029,79000,79000,4.3,9,21
0,0,"Combo 4 Quan lot, quan sip dui Boxer vai Cotton cao cap danh cho nam ( Mau ngau nhien)- Le Ngoc Fashion",125000,125000,4.8,31,87
0,0,Quan the thao nam -quan Jogger Nam chat UMI loai 1 da cao cap,78000,78000,0,0,
0,0,AO KHOAC PHAO NAM THIET KE CHO MUA DONG AM AP PHONG CACH NANG DONG CUA PHAI MANH,207000,207000,3,7,13
0,0,MAY 10 - Quan DUI mac nha + mac ngu (HANG HIEU GIA SHOCK),65000,65000,4.1,27,167
0,0,Ao Thun Nam Tay Lo Unisex Form Rong COME BACK Ulzzang,38000,38000,3.9,12,25
55000,50,Ao ba lo nam tron du mau chat cotton co dan mem min mat me,110000,55000,3,37,119
0,0,"Quan tay au nam cao cap chat vai tuyet co gian 4 chieu , chuan thiet ke han quoc, cuc ton dang, lich su, tre trung",95000,95000,0,0,
159200,44,"Quan Bo Nam cao cap  thuong hieu Chandi, chat jean co dan Hot Trend 2021 ma MR9037",358200,199000,4.6,37,82
0,0,Quan Tay ( Au ) Nam Dang Han Quoc - Den - 28,81000,81000,5,4,41
0,0,Quan Nam Kaki Basic Dang Baggy Tron Mau Phong Cach Tre Trung Thoi Trang Zenkonu QUAN NAM 1000060V1,39000,39000,0,0,3
62000,33,Quan Lot Nam Jockey Tam Giac Ban To Thun Cotton Compact - JMMB7336,190000,128000,4.6,15,90
0,0,Do Bo Ni Nam Thu Dong Nam Hoa Tiet Moi,166000,166000,3,6,13
0,0,Hop 5 Quan Lot Boxer Nam SZone Ca Tinh Hop Quan Sip Hinh Sao,219000,219000,4.3,24,81
159200,44,"Quan Jean Nam cao cap chat bo sieu co dan Thuong Hieu Chandi, form dung dang dep mau moi sieu hot 2021 MR9081",358200,199000,4.8,40,71
0,0,"Quan dui thai,quan dui dai nam cap thun sieu dep",49000,49000,1.3,3,20
214500,50,"Quan Short Nam Kaki 5S (6 mau), Chat Lieu Vai Kaki Cotton, Ben Mau, Co Gian Tot (QSK21050)",429000,214500,4.6,79,177
0,0,"Ao Khoac Kaki Nam 2 Lop Co Tui Trong, Ao Khoac Thoi Trang Han Quoc",159000,159000,3.9,172,428
60000,50,quan ni nam nu soc thu dong am ap,120000,60000,5,3,5
86600,50,Do bo nam nu in logo chat vai thun lanh in chuyen nhiet co gian 4 chieu,173200,86600,4.6,9,21
46000,20,Ao khoac kaki nam 2 lop Hahaman cao cap mau moi 2021 AKK40 nhieu mau,235000,189000,1,2,5
103200,44,"Ao Thun Nam Ngan Tay Chandi, Chat Thun Cotton Xin Mau Moi NT19",232200,129000,4.8,20,43
0,0,Combo Ao thun Teeworld Angry Bear T-shirt va Saigonese Co Ba Nam Nu Form Rong Unisex,678000,678000,4.5,2,3
0,0,"Ao khoac nam GOKING chuyen chong nang, 6 tui tien dung, vai day cong nghe Nhat Ban cao cap",289000,289000,5,18,42
0,0,Ao len nam co tron ao len nam det kim thoi trang ca tinh,170000,170000,3,2,2
127200,44,"Quan jean nam chat jean xin Julido, Phoi rach mau moi form dep ton dang khong qua om mau Top02",286200,159000,4.3,32,62
0,0,"Ao thun nam phong tron Casual 1st co tim tay ngan coc, vai 100% cotton cao cap thoang mat, tham hut mo hoi, form ao tre trung thich hop di lam, di choi, dao pho, du lich, Made in Vietnam",135000,135000,4.5,78,249
0,0, Ao so mi nam dai tay viet tien mau xanh duong lai bau regular,350000,350000,4.2,5,14
47000,39,QUAN NGU NAM THUN 100 % COTTON FEZZIO,119000,72000,4.7,9,19
0,0,Ao len nam co tron BS83,239000,239000,0,0,
0,0,Quan dui nam loai caro nho vai thun mem mat free size duoi 65kg,29000,29000,3,3,46
0,0,Ao Thun Unisex Bad Rabbit Rabbitkita Dark Green 100% Cotton - Local Brand Chinh Hang,350000,350000,4.3,3,4
159200,44,"Quan Jean Nam chat jean xin Thuong Hieu Chandi, Phoi rach mau moi form dep ton dang HD12",358200,199000,4.8,30,34
159200,44,"Quan Jean Nam cao cap chat bo sieu co danThuong Hieu Chandi, form dung dang dep mau moi sieu hot 2021 MR9035",358200,199000,4.7,19,24
0,0,Ao thun nam co tron tron The Basic chat lieu cotton mem mai,89000,89000,4.5,13,52
79200,44,"Ao thun nam the thao tron, co tron dep, tre trung, mac thoang mat, tham hut mo hoi tot thuong hieu CHANDI HH2",178200,99000,4.3,12,41
0,0,Ao khoac gio nam vai du lot caro Nexx&Dee co size lon big size tre trung nien AK01,269000,269000,4.7,3,6
0,0,"Ao khoac gio nam GOKING phoi vien sieu dep, mu dau gon gang, hang hieu cao cap xuat khau",255000,255000,4.8,39,77
111200,44,"Do Bo The Thao Nam thuong hieu Chandi, Do Bo Mac Nha chat lieu thun cao cap mat me, tham hut mo hoi tot MS9011",250200,139000,4.3,18,52
160000,42,"Quan jogger nam tui hop K108 chat kaki mem min, phong cach duong pho",385000,225000,4.2,5,11
20000,34,Quan lot nam Roman cao cap - 2 lung voi chat lieu thun lanh silk 4 chieu cuc mat.,59000,39000,5,8,49
0,0,Ao Thun Bad Habits REBEL LONG SLEEVES Dai Tay,360000,360000,4.5,4,6
151000,50,Ao so mi nam caro cao cap dai tay SM071,300000,149000,4.3,8,47
0,0,Ao Thun Tron Nam - Nu Unisex,45000,45000,4,6,17
61000,8,"Ao khoac nam AP43, Ao phao nam lot long co mu trum dau dang om phong cach don gian doc dao ca tinh",750000,689000,5,3,4
49000,50,Ao Thun Nam Tay Dai D402,98000,49000,0,0,8
81000,41,Ao thun nam dai tay co be Hahaman cao cap nhieu mau CBDT01,200000,119000,4.6,17,63
0,0,Bo do the thao nam,69000,69000,4.3,49,97
0,0,"Ao Gio 2 Mat Pmax, 2 Lop, Mac Cho Ca Nam Nu, Chong Nuoc, Chong Gio, Chong Nang, Phom Tre Trung",239000,239000,4.7,15,22
0,0,Quan Dui Nam The Thao Form The Thao Chat Vai Poly Co Dan 4 Chieu Thoang Min Hang Cao Cap Big Sport,159000,159000,4.2,12,29
0,0,Ao Thun Nam SINO Ngan Tay Thoi Trang - Dang Om Body Sieu Ngau,108000,108000,3.9,15,67
0,0,"Ao Khoac Hoodie Unicorn Ngua Mot Sung Unisex - Ao Khoac hoodie Ni nam nu Thu Dong Uniex, Ao Hoodie phan quang 7 mau NGUA 1 SUNG form duoi 70kg decan in xin, ao hoodie co non ulzzang quang chau",105000,105000,5,2,2
0,0,Ao khoac du nam form rong,127900,127900,4.2,26,51
0,0,Bo quan ao the thao nam,71000,71000,0,0,4
0,0,"QUAN JOGGER KAKI CO GIAN, KHOA ZIP CA TINH, Quan jogger kaki co gian khoa zip, du size, du mau, Quan Jogger kaki co gian khoa zip khong ra mau, khong do long, Quan jogger kaki Nam NU khoa zip len form, dep dang, Quan jogger kaki tron dep",84000,84000,0,0,3
0,0,Ao thun game thu thi dau Esports G2 Pro 2021,199000,199000,5,4,12
0,0,"Ao ni hoodie nam nu in hinh doc la form rong han quoc duoi 70kg, chat ni mem min, Ao ni hoodie nam nu form rong,Ao hoodie nam , ao hoodie nu , ao khoac ao hoodie cap doi nam nu mac",107000,107000,4.5,10,18
50000,42,QUAN NGU NAM THUN 100 % COTTON FEZZIO,119000,69000,5,6,34
0,0,"AO KHOAC NI CO MU NAM NU CUC DEP , SIEU CHAT 2021 THOI TRANG LANO STORE",97000,97000,0,0,1
0,0,Quan Jogger ran ri Nam cao cap - Phong Cach thoi trang nam ca tinh 2019,87000,87000,2.3,13,45
0,0,"Ao thun tay dai hoa tiet thoi trang nam King168 , ao phong tay dai cao cap nam P28",0,129000,3.5,2,
0,0,"Quan sot jean thoi trang cao cap nam King168 , quan short jean nam K15",0,150000,3,4,
0,0,Ao thun nam co tron loang mau hoa tiet hoat hinh hot trend 2021 - TOP NAM 90000182,69000,69000,2.3,3,4
0,0,"Hop 4 quan lot boxer, sip dui thong hoi cao cap danh cho nam cotton co dan bon chieu om sat co the mang lai cam giac mat me thoai mai suot ca ngay.",140000,140000,4.6,29,132
31000,39,Quan lot nam tam giac mem min thoang mat TKQLPG01 PigoFashion,80000,49000,4.8,4,54
0,0,AO THUN NAM DAI TAY CO SO MI PHONG CACH HAN QUOC ATD01-XANH DEN,193700,193700,4,6,17
0,0,[ Anh That ] Ao thun tay lo form rong hoa tiet THE OTHER - Unisex nam nu deu mac duoc,79000,79000,5,2,10
101000,36,"Quan Dai Tui Hop Nam Nu E'mer , Quan Suong Ong Rong Kaki Form Rong Unisex",280000,179000,5,4,12
0,0,AO KHOAC NAM VAI NHAP HAI LOP CO TA DONG NUT IN CHU MERCI HOT TRIEND SIEU DEP,149000,149000,4.5,25,43
51000,43,Quan dui nam THE 1992 vai dui Quan short coc LINEN,120000,69000,4,23,51
61000,27,Ao thun polo nam ngan tay co co ao phong nam phoi bo cao cap TKAHT08 PigoFashion nhieu mau chon lua,230000,169000,4.2,12,21
0,0,COMBO 3 quan dui sip nam Nhat Huy chat cotton sieu mong,130000,130000,5,3,16
0,0,"Ao khoac jean nam , ao khoac bo cao cap MS989",220000,220000,2.5,2,3
0,0,Ao so mi nam coc tay MAY 10 ma  010120003 AH239,303000,303000,4.8,8,13
41000,20,Quan short ni nam cao cap ong suon tui khoa keo – FORMEN SHOP – FMPS116,210000,169000,5,6,21
0,0,"Ao khoac nam ao gio nam vai du 2 lop day dan, chong tham nuoc cao cap, ao khoat dep Han Quoc - GTAKS23",194000,194000,4,7,14
200000,44,"Ao khoac jeans nam , ao khoac nam xanh GT02 form vua chat lieu mem mem co dan loi cuon co mu co 3 size Julido mau khoac AKJ8687 thoi trang lich lam han quoc tre trung hien dai",450000,250000,5,5,22
79200,44,"Ao thun nam dai tay Julido, Chat thun cotton xin bo tay va hong mau thu dong T5555",178200,99000,4.8,33,52
0,0,ao khoac da nam nu,289000,289000,4.8,4,20
35000,31,[ Co Anh That ] Ao thun unisex tay lo form rong - soc tem tron,114000,79000,4.5,4,6
0,0,Ao thun tay lo Wind phong unisex form rong Hai Tac nam nu oversize ulzzang,61000,61000,5,3,10
0,0,Ao so mi nam ngan tay form rong nhieu mau sac noi bat doc dao ,99000,99000,4.8,4,6
40000,31,QUAN SHORT KATE SPANDEX FEZZIO CHINH HANG FZ-05 NEO ,129000,89000,5,8,23
0,0,Combo 5 san pham Quan lot nam tam giac  thuong hieu Davie chat lieu cotton cao cap co dan 4 chieu DV006,250000,250000,4,6,9
0,0,do mac nha cotton  nam 9935,275000,275000,4.6,8,21
0,0,Ao So Mi Nam SM213,201500,201500,3,2,3
34000,30,[ Co Anh That ] Ao thun unisex tay lo form rong - phong once piece,113000,79000,5,4,3
0,0,Bo pyzama ngan tay mac nha nam trung nien_hang san co,335000,335000,5,4,10
0,0,"(VIDEO) Ao Len Nam Co Cao 3 Phan, Chat Lieu Day Dan Phong Cach Han Quoc AL03",249000,249000,2.7,3,7
0,0,"Ao thun phan quang OFF WHITE mui ten tay lo unisex ( Den, Trang )",83000,83000,5,9,13
0,0,Ao khoac Du Vien tui hop form rong unisex - Ao khoac Nam nu Unisex mau Den/ Be ,179000,179000,4.2,5,16
0,0,Ao thun nam tay dai,79000,79000,3.8,9,28
0,0,Bo Quan Ao Nam Ao Thun Quan Jogger In Chu Phong Cach Tre Trung Thoi Trang Zenkonu TOP NAM 1000126 + QUAN NAM 1000069,109000,109000,3.4,5,14
0,0,Ao So Mi Nam Dai Tay AD001,132000,132000,4,8,16
80000,24,"Quan baggy nam Amazing, chat lieu kaki, lung thun co giay rut, form om Unisex, ton dang dep, tre trung",339000,259000,4.6,44,97
0,0,"Quan Dai Jogger Nam Ong Con Phong Cach Han Quoc, Chat Vai Si Gio Mem Min, Cap Chun, Theu Logo Phong Cach",39000,39000,2.3,6,17
0,0,Ao khoac ni bomber unisex nam nu ,97000,97000,0,0,
171000,57,AO SO MI NAM HAHAMAN CARO COTTON CAO CAP NGAN TAY TRE TRUNG SMNT01006,300000,129000,4.6,7,18
144000,44,"Quan Short Jean Nam co dan kieu dang tre trung don gian Thuong Hieu Chandi, quan sot mau moi xu huong 2021 QSJN250",324000,180000,4.8,17,39
90000,41,"Ao so mi nam ngan tay co vest chat mem Lados - 8063 , form dep , thoang mat",219000,129000,5,3,4
0,0,Ao T-Shirt Nam Co Tron IMVMAN TS-TR3 - Trang ,130000,130000,5,2,143
0,0,"Quan Jeans Nam 2019,quan jean cao cap hang nhap J46",99000,99000,4,6,31
99500,50,"Ao Thun Nam 5S Co Tim (ATSSB199) Cao Cap Tre Trung, Thoang Mat N2",199000,99500,4.7,194,469
0,0,BO QUAN AO THU DONG NAM DAI,279000,279000,4.8,4,16
0,0,Ao thun nam tay ngan co co polo coton cao cap vai min mem sieu mat size 50-80kg soc co soc tay,39000,39000,1,1,7
78000,26,"Combo 3 ao ba lo nam, ao 3 lo nam, soi cotton mem min, tham hut mo hoi tot, thoang mat, mac thoai mai JAMANO",297000,219000,5,4,25
247000,50,Quan short jeans nam GUMAC QJNB680,495000,248000,5,3,5
0,0,Ao so mi nam dai tay tron khong nhan vai lua thai CUC MAT loai ao so mi form slimfit,69420,69420,4.1,14,26
197000,50,Ao polo nam GUMAC ATNB7100 theu,395000,198000,5,4,9
0,0,[ Anh That ] Ao khoac nhung gan bomber Zombie nam nu cap doi mac -Form rong Unisex Bomber jackets nhung nam - Hien Linh Shop,143000,143000,3,3,3
66000,40,"Combo 3 Quan lot nam, sip dui nam xuat Nhat thoi trang cao cap - ZQN07 (Mau giao ngau nhien)",165000,99000,3.7,6,75
159600,40,Ao so mi Slim Fit Shirt Blamor form om chat lieu lua cao cap hang vnxk_ASM080,399000,239400,5,7,18
0,0,"Ao khoac mong thu dong dang dai in hinh tre trung, nang dong - AO KHOAC NAM 9000020C",109000,109000,4.2,5,8
48000,24,Ao Thu Dong Nam Dai Tay Giu Nhiet Thoi Trang ZERO,198000,150000,4.8,28,51
116000,47,"Ao Thun Tshirt Nam Ngan Tay Co Tron (5APKB004CAD) Chat Lieu Cao Cap Tre Trung, Thoang Mat Chinh Hang BILUXURY",245000,129000,4.7,3,13
299000,50,Ao Khoac Nam Bomber 4 Mau Hai Lop Nhung Tam Cao Cap VICERO,598000,299000,3.7,3,5
180000,45,"Ao Thun Nam Polo Ngan Tay Co Be (5APCB006) Nhieu Mau Sac Tre Trung, Nang Dong, Chinh Hang BiMan By BiLuxury,Kieu Dang Body Fit Lich Lam, Sang Trong",399000,219000,4.7,18,30
144000,37,"Quan Short ,Quan Dui Nam Kaki Chinh Hang Biluxury (5QNKB001) Chat Cotton Cao Cap Thoang Mat Mem Min Khoa Cuc Tien Dung Phom Slimfit Om Vua Phong Cach Tre Trung",385000,241000,5,9,20
0,0,Ao lot nam co tay Cotton 100% mem min co gian tot tham hut mo hoi mac de chiu thoai mai,29000,29000,4.2,21,199
170000,43,"Quan Short ,Quan Dui KaKi Nam Chinh Hang Biluxury (5QNKB003BES) Chat Cotton Cao Cap Thoang Mat Mem Min  Phong Cach Tre Trung",399000,229000,3,2,10
0,0,- Ao thun nam tron vai ca sau cotton cao cap ngan tay tong mau cuc hot,78000,78000,0,0,5
0,0,Ao So Mi Rong Tay Ngan OVERSIZE Giau Nut Form Rong UNISEX Nam Nu Vai Lua Mem Mat It Nhan - SMN01,125000,125000,5,2,4
0,0,Ao so mi nam ngan tay vai so mi  chong nhan cao cap,98000,98000,4.3,33,170
127200,44,"Quan jean nam co dan Julido, chat bo form dung Skiny khong qua om dang dep mau LKL01",286200,159000,4.5,61,134
300000,33,Ao Khoac Linh Nam Lot Ni Cao Cap Sieu Am,899000,599000,4.7,7,19
80000,30,Ao thun nam dai tay co tru Prime Henley Cotton Compact Premium thuong hieu Coolmate,269000,189000,5,9,28
159200,44,"Quan Jean Nam cao cap co dan 4 chieu Thuong Hieu Chandi, phong cach han quoc tre trung ca tinh MR9019",358200,199000,4.8,30,68
0,0,Quan Jean Nam Xanh Dam S20,131000,131000,3.4,39,207
144000,44,"Quan Short Jean Nam co dan kieu dang tre trung don gian Thuong Hieu Chandi, quan sot mau moi xu huong 2021 QSJN261",324000,180000,5,16,39
0,0,Quan Short Nam Thun Cao Cap Mau Den Thoi Trang - TC04052,169000,169000,3.7,3,11
0,0,Quan Short Kaki Nam,89000,89000,3.3,3,7
0,0,Quan Short The Thao Nam Chat Thun Co Dan 4 Chieu QS88,99000,99000,4.5,40,189
26000,20,Quan dui nam cotton iBasic SHM001,129000,103000,4.3,3,28
0,0,Ao hoodie nam / ao hooodie nu / ao hoodie form rong / ao khoac nam co non trum dau / ao hoodie cap doi / ao khoac cap doi in con hac,89000,89000,4.3,4,17
51000,32,Combo 4 quan lot nam cao cap | cotton phoi luoi CITYMEN | quan lot nam | Cap cao 4cm co gian 4 chieu | Giao mau ngau nhien,160000,109000,4.8,24,61
0,0,Quan ni nam nu Unisex Hot Trends ASALA (M-4),39000,39000,4.1,9,25
0,0,AO KHOAC JEAN NAM PHOI NON TRE TRUNG- CHUAN CHAT SOAI CA,129000,129000,4.8,6,18
156000,39,Ao thun nam nu Unisex Chu Vien co NOCROSS nhieu mau doc la Ao thun nam tay lo mau den trang Trum Unisex aothununisex,400000,244000,5,2,2
0,0,Ao thun Teelab Viet Nam TS126,195000,195000,3.8,4,10
159200,44,"Quan Jean Nam dep dan dau xu huong Thuong Hieu Chandi , mau moi form dep ton dang khong qua om mau HD31",358200,199000,5,40,66
0,0,Ao thun Teeworld Smudge Lord - Woman Yelling at a Cat Tay Lo Form Rong Unisex Nam Nu,329000,329000,5,7,16
299000,50,Ao Khoac Nam 2 Lop Tran Long Cao Cap VICERO,598000,299000,4.3,175,330
239000,44,Ao Khoac Nam Vai 2 Lop Tran Long Thoi Trang VICERO,538000,299000,4.5,42,82
0,0,Quan kaki ong rong nam trung nien vai cotton day dep CHAC CHAN HAI LONG may boi Thai Khang,159900,159900,4.7,17,25
0,0,"Ao thun nam tay dai King168 , ao phong nam dai tay cao cap ATD13",0,100000,4.8,5,
0,0,Combo 5 Quan dui mac nha nam ( giao mau ngau nhien ),119000,119000,5,2,119
0,0,AO KHOAC NAM LOT LONG CUU SIEU PHAM AO KHOAC MUA DONG PL08,59000,59000,1,3,19
0,0,Quan Dai Nam Dui Trang Khuy Cai Khoa Keo Chat Dep DUICAITRANG98,49000,49000,2.7,3,8
0,0, Quan sip quan lot nam tam giac munafie cao cap,10000,10000,4.2,27,225
0,0,Quan Sip Nam Tam Giac Thun Lanh Khang Khuan Co Gian 4 Chieu Thong Minh,8500,8500,5,6,66
0,0,Sieu Sale ao len nam co lo nam thoi trang- ao len nam - ao len co cao - ao len form om dang,99000,99000,3.8,8,38
0,0,Ao khoac hoodie nam 4YOUNG phong cach Han Quoc Cau Vong,59000,59000,5,2,61
0,0,"Ao thun ba lo nam Cao cap,tham hut mo hoi,chat thun co gian mem min full hop nhu hinh ",38000,38000,4.8,36,129
0,0,Ao lot nam Dong Xuan mau trang coc tay va ba lo hang VNXK,76700,76700,4.8,5,76
159200,44,Ao Thun Polo Nam Co Be Tay Ngan Chat Lieu Cotton Co Gian Thoi Trang Men Luxury PL8,358200,199000,5,5,14
30000,17,Quan Au Nam dang baggy Han Quoc - QA01,179000,149000,5,7,16
187000,49,Ao Thun Nam Jockey Cotton Pima Ngan Tay In Chu  - JUMT0318,385000,198000,4.3,3,16
0,0,"quan jean baggy rach goi RG-03 ong suong, rong style han quoc 2021",165000,165000,0,0,2
165000,47,Quan kaki nam song suong thoi trang VICERO,350000,185000,4.3,152,547
209000,50,Bo The Thao Nam Chat Ni 4 Mau Tre Trung Nang Dong Thoi Trang Cao Cap VICERO,418000,209000,4.1,50,139
258000,52,"Ao Thun Nam Polo Ngan Tay Co Be (4APCT016) Chinh Hang BILUXURY ,Chat lieu Cotton Cao Cap,Kieu Dang Body Fit Lich Lam, Nhieu Mau Sac Tre Trung, Nang Dong",499000,241000,3.4,5,9
126000,60,"Ao thun nam ca sau in GUMAC du mau du size, thiet ke basic ATNB140",210000,84000,4.6,54,124
53000,45,Quan Sip Nam Tron 3 Mau Co Gian Thoi Trang VICERO Cao Cap,118000,65000,4.8,4,37
0,0,Quan ngu nam sexy LN056,71000,71000,5,9,33
0,0,Quan dai dui nam ong suong chat mat,125000,125000,4.3,62,197
0,0,Ao thun 3d - Ao thun polo big size - Cac kieu Ao thun cho nguoi map nam,68000,68000,4.5,4,15
351000,39,Ao khoac Bomber Varsity The Bad God Saigon,900000,549000,2.5,2,3
0,0, Ao thun cotton nam nu - Ao thun nam co co big size - Ao thun nu danh cho nguoi map,68000,68000,2.7,10,37
0,0,Ao so mi nam tay dai theu hoa tiet moi nhat,83000,83000,4.5,45,120
0,0,"Quan au nam ong con theu hoa tiet vai lua co gian,quan tay nam khong nhan khong xu 3 mau(QATO)",130000,130000,4,3,6
115000,50,Ao so mi nam in la co GUMAC ANB6111,230000,115000,5,7,15
0,0,Ao khoac kaki  Nam UNISEX  Mau  den ,199000,199000,3.9,92,435
0,0,Ao Mang To Nam Dang Dai - Ao Khoac Da Nam Dai Sans13 Sans Shop San Shop,0,490000,3.7,3,
171000,57,AO SO MI NAM HAHAMAN CARO COTTON CAO CAP NGAN TAY TRE TRUNG SMNT01013,300000,129000,4.2,5,12
0,0,Ao thun Teelab Not Cool TS117,350000,350000,4,1,2
0,0,Quan dui the thao nam vai thun lanh co gian 4 chieu (combo 3 cai),100000,100000,0,0,
59000,50,Ao thun nam nu unisex tay lo phong form rong teen co tron oversize cotton gia re basic den trang tee pull YOUNG BOY,118000,59000,4,5,13
59000,50,Ao thun unisex nam nu tay lo phong form rong teen co tron oversize cotton gia re basic den trang tee pull CHIBI HOAT HINH ,118000,59000,5,5,11
59000,50,Ao thun nam nu unisex tay lo phong form rong teen co tron oversize cotton gia re basic den trang tee ulzzang DMXB,118000,59000,4.5,2,8
59000,50,Ao thun nam nu unisex tay lo phong form rong teen co tron oversize cotton gia re basic den trang tee pull TOM&JERRY FRENDSHIP,118000,59000,3.6,8,24
51000,11,Ao so mi nam dai tay Nano-Tech Easycare chong nhan thuong hieu Coolmate,450000,399000,5,3,26
0,0,Quan kaki nam dai Santino chat lieu cotton cao cap dang slim tre trung sang trong KSG525K616,380000,380000,4.8,12,25
85000,43,"Quan short jean nam cao cap form chuan dep, do co gian tot mac thoai mai, khong phai mau, phong cach tre trung hop thoi trang",200000,115000,5,4,16
166000,55,"QUAN NI NAM, QUAN THE THAO 3 SOC DAI - MA HD 06",300000,134000,4.5,11,25
109000,46,"Combo 10 quan lot nam CM, Thuong hieu CITYMEN, do lot nam hang Viet Nam xuat khau",238000,129000,4.5,171,535
0,0,"Quan Short Nam W&W Cap Chun, Chat Lieu Cotton Nhe Mat, Tham Hut Mo Hoi Khong Bai Xu, Can Chi SHORT03",99000,99000,4.5,2,4
35000,18,[HANG XIN - 3 LOP] Quan Jogger Nam Thun Ni Lot Long Cuu Am Ap - Hang chinh hang dododios,200000,165000,5,7,20
0,0,Quan Jean Nam Mau Xanh Dam Cao Cap Phong Cach Han Quoc ms376,130000,130000,4.5,11,18
173000,51,Bo Mac Nha The  Thao Nam Mua He Thun Mong Cao Cap ZERO - BTT19 XAM - XL,338000,165000,4.5,8,16
0,0,"Quan Kaki Nam Tron ROUGH Outfit Chat Lieu Day Dan, Co Gian",195000,195000,3.5,8,28
211000,60,Quan Short KaKi Nam Thuong Hieu VICERO 6 MAU Tre Trung Nang Dong,350000,139000,4.3,45,161
0,0,Ao so mi unisex ASALA SM-02,59000,59000,4.3,11,31
249500,50,Ao Khoac Gio Nam YODY 2 Lop In Loang Truot Nuoc Co Mu Can Gio Bui - AKM4687,499000,249500,5,2,6
0,0,Ao Phong Polo Nam YODY Phoi Bo Tre Trung Chat Lieu Pique Mat Chim Thoang Mat - APM3299,299000,299000,4.5,22,46
0,0,Ao So Mi Nam Dai Tay Mau Trang Co Tui Chat Vai Dui Xuoc Chong Nhan Form Body ,275600,275600,4.5,2,2
251000,39,"Quan Jean nam den chat bo cao cap mem min co dan tot, tre trung thoi trang",650000,399000,4.8,4,18
0,0,"Combo 2 Ao phong ba lo thoat nhiet Nhat Ban , ao lot nam hang hieu cao cap xuat khau",258000,258000,4.8,61,191
0,0,Quan jean dai nam mau den rach goi in chu ca tinh,128000,128000,5,2,
0,0,bo thu dong (bo chu tay),104000,104000,3.2,5,13
0,0,Ao khoac Minimalism Hoodie Nam Nu Unisex,359000,359000,5,3,5
0,0,AO KHOAC JEAN NAM SIEU HOT VAI SIEU DAY PHUONGNAMSHOP20 MKTB16,155000,155000,4.3,3,8
0,0,Ao thun nam co tron tron chat lieu cotton mem mai,75000,75000,4.3,26,66
111200,44,"Quan short jeans nam , quan short nam eo co dan xanh rach loang 1 ti bac san lai thiet ke phong cach thoi thuong dao pho Julido mau JS097604 - Mau xanh rach nhu hinh",250200,139000,4.5,7,17
0,0,AO THUN UNISEEX NAM NU MV10-09-08,79000,79000,5,2,5
0,0,Combo 3 Quan Lot Nam 5THEWAY Tam Giac Den aka 3 PACK 5THEWAY HIP BRIEF UNDERWEAR in BLACK,390000,390000,5,2,3
0,0,Combo 3 quan lot nam cao cap U loi chat spandex tham hut mo hoi ,160000,160000,5,2,4
0,0,"Ao thun nam tay ngan co tron Obokfashion, ao nam phong cach Han Quoc ms7979",19000,19000,5,14,71
0,0,Quan Ni Nam Thu Dong Ni Lot Bong Va Ni Len Sieu Day Min Quan Jogger Nam,80000,80000,5,3,10
0,0,"Quan Sip Nam Cao Cap, Quan Lot Nam Thun Lanh, Hop 4 Sip Dui Nam Vai Soi Tu Nhien Thun Lanh, Thoang Khi, Co Gian 4 Chieu, Khong Phai Mau, Khong Xu Long, Tham Hut Mo Hoi, Thoat Hoi Va Khang Khuan Rat Tot.",199000,199000,2.5,2,6
0,0,Combo 10 Quan Lot Nam Thun Lanh X-Men Underwear MS1039,185000,185000,4.8,4,35
0,0,AO THUN NAM CO BE VIEN riley huynh,90000,90000,4.6,7,10
0,0,"Quan dui nam, quan short the thao nam ke vien vai cotton 65/35 mem, min nhieu mau",145000,145000,2.3,3,12
0,0,Ao Thun Nam Phan Quang Co Lam Thi Moi Co An,60000,60000,4.5,130,336
170000,47,Quan short nam tui hop S01 chat kaki cao cap mem min mat me,359000,189000,4.3,3,4
0,0,"Quan Jogger 3 soc lung the thao nam nu, vai POLY min mat, phong cach the thao",73000,73000,5,42,104
0,0,"Quan au nam ong con thoi trang, quan tay nam mac vest, ton dang, thoi trang, lich su, chat tuyet mua khong bai xu",129000,129000,4.3,4,5
111200,44,"Ao so mi nam lua soc caro Julido Store, xu huong moi nhat nam 2020 BZ02",250200,139000,4.3,18,38
0,0,Ao So Mi Dui Nam Ngan Tay Chat Dui Thai Thoang Mat Kieu Dang Tre Trung Nang Dong,68000,68000,3.7,6,15
205000,40,Combo 3 Ao Thun nam mau moi logo truóc ngục -  DB3QC16 (Chon Mau),509000,304000,4.2,91,301
143200,44,"Ao Khoac Nam, Khoac Du Nam 2 lop phoi non thoi trang han quoc tre trung cuon hut Thuong Hieu Chandi chat lieu tham hut mo hoi day dan mac thoang mat mau KD15",322200,179000,4.5,37,77
91000,26,Ao so mi nam tay dai ADINO mau trang kem giau khuy vai soi soi modal dang slimfit tre trung S301,350000,259000,5,2,3
74000,26,Ao thun nam co tron ngan tay cao cap dep chat vai cotton co gian 4 chieu thoang mat ZAVAS  Z16,289000,215000,5,4,8
125000,50,"Quan tui hop nam nu unisex chat kaki co gian min, dep, cuc chat",250000,125000,3.8,6,43
70000,24,Ao thun nam dep ngan tay co tron cao cap chat vai cotton co gian 4 chieu thoang mat ZAVAS  Z08,289000,219000,4.8,5,12
0,0,AO THUN NAM DAI TAY CO SO MI  ATD01,193700,193700,4.3,10,26
0,0,Quan Jean nam ong rong mau 2021 quan jean nam miuzi,209000,209000,4.5,2,2
0,0,Ao khoac nam trung nien day dep,205000,205000,3.4,12,52
0,0,Quàn short nam thẻ thao thuong hiẹu TORANO BW072,199000,199000,4.8,4,4
49000,50,Ao Thun Nam Tay Dai D404,98000,49000,4.7,3,6
0,0,Ao Thun Nam Phan Quang In Bo Ra Di Ban Eyyy,60000,60000,4.2,77,191
0,0,QUAN JEAN SUONG ONG RONG KHA BANH - MA JN686-,199000,199000,2.7,3,6
0,0,AO KHOAC JEAN NAM CO TRU,229000,229000,3.8,4,6
0,0,"Ao thun doi hieu ung phan quang cao cap chat lieu cotton 100% danh cho cap doi, thich hop di choi, hen ho, chup hinh cuoi C2.47",180000,180000,3.7,3,5
0,0,"Ao so mi cap doi nam nu tay ngan form rong hoa tiet khung long, chat lieu mem min thoang mat",120150,120150,4.7,7,24
0,0,"Ao thun tay lo unisex Yinxx, ao phong form rong ATL906",69000,69000,5,2,2
0,0,Ao Thun Youtube,65000,65000,3,3,8
0,0,"Quan dai nam dang au chat tuyet mua day dan khong bai xu, size tu 45-80 kg, dang om tre trung nang dong, chat vai co gian nhe",109000,109000,4.5,16,27
0,0,Ao Thun Nam Ao Thun Nam Co Tron Phoi Chu LV01 Thoi Trang Danh Cho Phai Manh,125000,125000,4.5,2,2
0,0,Quan Cartoon Pant Unisex Quan Hoat Hinh Lung Ong Rong Lung Thun- MM,122000,122000,4.5,2,4
0,0,"Combo 2 quan thun jogger the thao nam, lung thun va day rut co gian thoai mai",429000,429000,4.5,31,77
0,0,"Ao dui nam coc tay co tau chat dui thai mat thoang khi, ao phong nam co tau thoi trang mac chuan form, tre trung",85000,85000,4.2,33,68
0,0,MEOW EMPEROR - Ao Khoac Gio Lot Long Cuu Chong Nuoc Tuyet Doi Khoa Sport Cao Cap Mau Moi Nhat 2021,195000,195000,4.5,5,9
95000,68,Ao thun nam the thao HAHAMAN mua he tron day dan ATGR04001,140000,45000,5,3,13
0,0,"Ao nam chat cotton tay dai Unisex Form rong, sieu mem, mat SP4",165000,165000,5,4,7
34000,29,QUAN NGU NAM KATE FEZZIO 100% COTTON CO TUI SUON,119000,85000,4.5,21,69
171000,44,Ao thun tay lo GENZ tie dye acid wash Cotton - GTZ037,390000,219000,5,2,4
0,0,"Quan Baggy Nam ROUGH Style Han Quoc, Chat Nhung Tam Phong Cach Tre Trung, Nang Dong",195000,195000,3.5,4,9
0,0,Quan Sip Nam Thun Lanh ICON Quan xi nam BOXER nam co dan 4 chieu (Che Ten) - MINHSTORE,34900,34900,5,12,37
99000,42,Ao chong nang nam THE 1992 Ao khoac chong nang vai xuoc cao cap,238000,139000,5,2,6
87500,25,BO DO PIJAMA NAM QM163-QM197-QM198,350000,262500,3.5,4,7
159000,50,Ao polo nam ADINO mau den phoi vien chim vai cotton co gian dang slimfit tre trung nang dong AP80,318000,159000,4.8,5,7
0,0,Quan Jogger Kaki Nam Chat Mat - T05,87000,87000,4.5,5,16
0,0,"MAU MOI ️ Do bo the thao IN CHU LOVE - 90, set tap gym MAC o nha hay di choi deu dep phong cach, Do Bo The Thao Nam In Hoa Tiet 90 Doc Dao, Set Do Bo The Thao Unisex Nam Nu Vai Thun Lanh",94000,94000,5,3,5
0,0,Ao so mi nam dai tay ke caro 8TH19A001 Canifa,199000,199000,5,6,14
0,0,"quan jogger, quan the thao nam, quan nam dai, quan nu dai, quan the thao nam nu deu mac duoc, quan thun nam nu, quan thun dai, quan the thao nam nu, quan jogger nam nu",80000,80000,4.7,3,7
90000,24,"Quan tay nam ong con Amazing, dang tre om gon, nhieu mau nam tinh, chat lieu co gian, phong cach Han Quoc, tre trung, nang dong",379000,289000,4.6,7,15
60000,29,"Ao Thun Nam Unisex thiet ke hinh tron 3 mau Den / Trang / Tim than basic thuong hieu Japas Cotton Ai Cap 190gram, ao phong co tron basic dai tay thoang mat, tham hut mo hoi - Hang chinh hang",209000,149000,4.7,29,120
0,0,"Ao thun tay dai unisex form rong Tron nam nu basic tea phong cach ulzzang, ao sweart nam nu, Ao Thun Tay Dai Ullzzang [Unisex - Du Mau]",75000,75000,4.3,11,27
0,0,Ao ni doi sweater nam nu thu dong hinh meo Mochi cuc dang yeu,123380,123380,4.5,8,24
84000,42,"AO GIU NHIET NAM, CHAT THUN CO GIAN 4 CHIEU",200000,116000,4.5,11,30
0,0,"Ao khoat Bomber vai Nhung mang dam chat Vintage,len hinh bao dep THOI TRANG KING STORE",140000,140000,0,0,1
0,0,Ao Sweater Nam bigsize SST14,71000,71000,4.3,41,107
0,0,AO SO MI NAM HOA TIET CHIEC LA - HANG CAO CAP 100% UY TIN,94000,94000,4.3,22,54
61000,29,Ao thun nam ngan tay co tron hoa tiet in tay chat lieu thun cotton - FORMEN SHOP - FMPS165 ,210000,149000,4.5,2,6
0,0,"Ao so mi caro nam tay dai ao ke caro chat vai bo mem khong nhan, thiet ke tre trung unisex cho ca nam va nu",149000,149000,5,3,9
0,0,Ao So Mi Nam Dai Tay Ke Karo Thoi Trang - Hang Xuat Khau Cao Cap,132000,132000,4.3,20,108
0,0,AO KHOAC NHE NAM 2 LOP SIEU PHAM HOT TRIEND PHONG CACH HAN QUOC IN CHU NIKG,149000,149000,4.5,69,130
0,0,Ao thun nam tay lo form rong Unisex ,79000,79000,3.9,100,242
0,0,"AO THUN NAM , AO THUN 3 LO NAM SIEU DEP , CUC CHAT , PHONG CACH THE THAO THOI TRANG 1HITSTORE1",55000,55000,5,2,5
71000,27,Ao thun nam ngan tay ao polo co co chat vai cotton min mang thoang mat TKPPL32 PigoFashion chon lua mau,260000,189000,4.5,11,49
0,0,"AO KHOAC DU NAM BOMBER UNISEX MAU SAC SINH DONG,KIEU DANG SANG TRONG MAU MOI NHAT HIEN NAY",97000,97000,5,2,5
0,0,Bo thu dong nam gio san cao cap,550000,550000,3.7,21,53
0,0,Combo 2 Goi Quan Lot Giay Nam Procare PP - Trang,42000,42000,4.5,28,950
0,0,Ao Khoac Du Nam Co Non Phoi Tui 2 lop AN77 - Den,199000,199000,0,0,
0,0,"Ao len cao co nam cuc chat, hang dep nhap Quang Chau",250000,250000,4.6,8,21
80000,44,"Ao thun nam co be tay ngan tre trung, chat lieu cotton cao cap mau THUU67",180000,100000,3.8,22,44
76000,31,Ao khoac jean nam thoi trang cao cap,245000,169000,4.1,32,79
0,0,QUAN AU NAM TRUNG NIEN ,204000,204000,0,0,4
0,0,Bo Quan Ao Nam Ao Co Tron Loang Son Quan Short Nam Phong Cach Thoi Trang Zenkonu TOP NAM 1000148 + SHORT NAM 1000023,89000,89000,5,2,6
0,0,"Quan thun jogger logo in khong bong troc chat thun da ca mem min form dep, quan dai nam heroes, Quan the thao nam nu mac , quan thun nam ,quan dai nam, quan ni , quan jogger 2 soc, quan thun",95000,95000,5,4,5
127200,44,"Quan jean nam cao cap co dan 4 chieu Julido, phong cach han quoc MM19",286200,159000,4.5,96,199
0,0,Ao T-Shirt unisex Mikenco Couture - Trang,500000,500000,4.5,2,2
10000,6,Ao Hoodie Nam In Hinh Phan Quang Mau Moi,169000,159000,4.3,96,250
0,0,Combo 4 quan lot nam thong hoi Nhat mem mai co gian khong gay han da,54000,54000,5,5,17
0,0,QUAN JEAN NAM TRANG PHOI MAU,155000,155000,4,2,10
16000,8,Ao Khoac Da Lon l Lot Long 2020 Cam Ket Chat Luong Nhat Thi Truong,205000,189000,3.5,11,36
163800,35,Ao so mi nam tay dai form om Khatoco A1MD468S1-THCR070-2012-D - Caro xanh,468000,304200,5,4,8
0,0,Set Do Ngu Ngan Tay Tron Danh Cho Nam - Bo ngu Tron,110000,110000,1.7,6,13
0,0,Ao so mi nam co tru cai het cuc ,149000,149000,4.6,12,30
76000,31,Ao Khoac Kaki Nam Hai Lop Co Tru Gia Vest Cao Cap KK43 - ShopN6 (Nhieu Mau),245000,169000,3.9,20,45
46000,20,Ao Khoac Nam Big Size Ao Khoac Kaki Nam Chong Nang Chong Gio Chong Lanh Chong Nong Co Co Day Hai Lop Do Phuot Han Quoc Cao Cap KK51 - ShopN6,235000,189000,3,8,14
109600,20,OWEN - Áo so mi tráng OWEN chát Nano khong nhan (REGULAR/SLIM),548000,438400,5,16,32
176000,41,"Quan jogger nam tui hop chat kaki cotton mem min, phong cach duong pho R3",425000,249000,4.7,6,19
160000,38,"Ao Thun Nam Polo Ngan Tay Co Be (4APCT017) Chinh Hang BILUXURY ,Co Gian Tot, Tham Hut Mo Hoi Kieu Dang Body Fit Lich Lam, Nhieu Mau Sac Tre Trung, Nang Dong",419000,259000,4.3,7,22
0,0,Ao thun polo nam trung nien tay lo co co vai cotton mat loai ao thun ngan tay co co trung nien phoi soc co soc tay,99000,99000,4.7,3,3
0,0,"Combo 3 Quan lot nam, sip dui nam thong hoi cao cap (Mau ngau nhien)",59000,59000,4.5,6,12
0,0,Ao Khoac Jean Nam Den Huy Hieu,165000,165000,0,0,
0,0,Ao so mi nam dai tay co tru mau trang ,149000,149000,4.8,4,29
105000,28,"Combo 2 Ao Thun Nam Tron Body Co Tron Tre Trung Nang Dong, Soi Cotton Cao Cap Mem Min Sieu Thoang Mat, Tham Hut Mo Hoi, Co Gian 4 Chieu MRM FASHION",370000,265000,4.5,33,136
0,0,Ao thun nam polo tron vai ca sau cotton ngan tay cuc sang trong lich lam loai ao thun nam co co nam,99000,99000,4.5,5,12
6000,4,Ao Hoodie Ni Alan Walker Nam Nu Dang Rong G130,165000,159000,5,2,6
80000,10,Ao Khoac Nam Biluxury ( 5AG2T009) Polyester 2 Lop Can Gio Chong Nuoc Chong Bam Bui Dang Cap Mac 2 Mat Da Nang,799000,719000,4.3,6,11
36000,31,[ Co Anh That ] Ao thun unisex tay lo form rong - phong theu 4 logo,115000,79000,4.6,25,40
0,0,"Ao Thun Nam Phan Quang In hinh  AM DUONG BAT QUAI , ao chat, di dem, di phuot bao ngau, nhin da mat",59000,59000,4.5,30,69
36000,15,Ao Khoac Big Size Ao Khoac Kaki Nam Chong Nang Chong Gio Chong Lanh Chong Nong Co Co Cao Day 2 Lop Thoi Trang Nam Tinh Han Quoc Cao Cap ShopN6 - QK51 ,235000,199000,3.4,8,17
0,0,Ao So Mi Trang Form Rong Unisex Nam Nu Tay Dai Han Quoc Kieu Co Be Vai Lua Nhieu Mau - SMD01,125000,125000,4.8,4,7
0,0,AO KHOAC KAKI NAM,174000,174000,4,1,3
150000,38,"Quan Short ,Quan Dui Nam Kaki Chinh Hang Biluxury (5QNKB005TTT) Chat Cotton Cao Cap Sieu Ben Thoang Mat Mem Min Khoa Cuc Tien Dung Phong Cach Tre Trung",399000,249000,5,4,19
190000,48,"Ao Thun Nam Polo Ngan Tay Co Be (5APCB003), Chat Lieu Vai Cao Cap Form Body Fit Thoang Mat, Lich Lam, Tre Trung, Sang Trong Chinh Hang BiMan By Biluxury",399000,209000,4.1,14,28
0,0,Blentino quan tay nam Cotton BL604,495000,495000,5,2,10
87000,34,Ao Khoac Nam Ao Khoac Kaki Nam Big Size Co Cao Hai Lop Chong Nang Chong Lanh Han Quoc Cao Cap AK35 - ShopN6 (Nhieu Mau),255000,168000,3.8,47,139
0,0,Ao thun nam nu phan quang phong rong hoa tiet sieu hot (UX-PQ-07),39000,39000,4.6,12,29
0,0,Bo Quan Ao Dui Nam Chat Min Mat SETDEN01 - Bo Dui Den,169000,169000,4.7,73,171
94000,30,"Ao Polo Nam co be TSIMPLE co tru theu tay lo vai thun ca sau Cotton thoi trang, chuan form, sang trong lich lam ",313000,219000,4,8,26
0,0,"Ao khoac du nam nu mac in noi / ao khoac gio nam nu mac / ao khoac du cap doi / ao khoac chong nang chong lanh tot , vai du 2 lop .  size L , XL",73000,73000,4.8,6,9
113000,20,OWEN - Áo So mi dài tay Owen Regularfit 22244 - Ao so mi nam dai tay,565000,452000,4.6,14,45
0,0,"Ao khoac du kieu bomber in ENJOG ca tinh, thoi trang, Ao khoac du Bomber chu phoi mau Unisex nam nu, Ao khoac du nam nu mac / ao khoac gio nam nu mac / ao khoac du kieu bomber / ao khoac cap doi / ao khoac form rong, Ao Khoac Nam Nu Unisex - Ao Jacket Bombers ENJOG 2 Mau",97000,97000,4.1,10,30
0,0,(RE VO DICH) Quan short lung tui 2 hop 2 ben hong quan,28000,28000,4,6,13
0,0,Ao Khoac ao bomber DCoins Embroidered Varsity Jacket Red Nam Kun Shop,199000,199000,4,2,4
0,0,Ao Van Toan (Special Edition) It’s Real Tee thun nam nu Cotton Hottrend,93000,93000,2.5,2,10
0,0,Combo 10 Quan Sip Nam Tam Giac Thong Hoi Xuat Nhat Cao Cap,143499,143499,0,0,
26000,27,"Ao thun phong nam form rong tay lo cao cap ARISTINO AC22 chat lieu cotton 100% thoang khi, co gian 4 chieu thoai mai van dong",95000,69000,5,2,12
280000,80,Ao So Mi Nam VICERO Co Duc Dai Tay,350000,70000,4.3,12,42
21000,21,"Combo 5 quan lot nam CM, Thuong hieu CITYMEN, do lot nam hang Viet Nam xuat khau",100000,79000,4.5,156,1195
0,0,Ao Thun Co Co Ca Sau 4 Chieu Nam Nu,89000,89000,4.5,566,2135
0,0,Quan Jean Nam TS351,115000,115000,0,0,
0,0,"Quan jogger nam tui hop chat kaki mem min, phong cach duong pho",79000,79000,1.5,2,6
165000,47,Áo Hoodie Nhieu Mau Tron Thiet Ke Nang Dong Thoi Trang Cao Cáp VICERO,350000,185000,4,9,18
0,0,"( BAN LE) Quan Lot Nam Hop 4 Mau Hang Nhat Noi Dia Cao Cap, Quan Lot Nam Quan Sip Nam Sip Dui Nam Thong Hoi Cao Cap",60000,60000,0,0,
111200,44,Ao khoac nam chat kaki 2 lop xin xo Julido Store mau moi theo xu huong thoi trang Trend MQ11,250200,139000,3.1,19,56
47970,41,"Ao thun unisex ao thun nam form rong tay lo , áo thun nam cổ tròn tay ngan ao thun unisex chu SANTALUCIA da quang",117000,69030,4.8,5,5
47970,41,"Ao thun unisex ao thun nam form rong tay lo , áo thun nam cổ tròn tay ngan ao thun unisex STYLE NEVER",117000,69030,5,3,5
0,0,Quan Jean Nam Co Gian Phong Cach Thoi Trang Han Quoc Cao Cap ms46,135000,135000,0,0,
0,0,Ao Khoac Ni Bong Ngoai Reception F Mem MIn - Form Unisex Cardigan Bomber Jackets Nam Nu Couple Thoitrangsihienlinh,88000,88000,5,4,9
0,0,Quan short kaki nam vai dep cotton day co gian tot mac mat thoai mai loai quan short day keo,49000,49000,5,1,2
0,0,ao thun nam trung nien ngan tay co co co tui vai cotton dep mat co size 85kg,79000,79000,4.6,13,69
0,0,Ao Len Co Lo Nam Phong Cach Han Quoc Sieu Am SAL222,115000,115000,4.1,19,56
0,0,Bo Quan Ao Nam Tay Ngan Co Be Ao Khuy Cai Quan Short Co Tui Kieu Dang Tre Trung Thoi Trang Zenkonu_QANAM1000071V1,99000,99000,4.5,5,15
68000,35,Ao thun nam GUMAC ATNB850 in chang trai nhieu mau,195000,127000,4.2,6,17
133000,50,Ao thun nam in chu california GUMAC ATNB670,265000,132000,4.8,14,42
0,0,"Ao Thun Nam Co Tron Tay Ngan Tre Trung Thuong Tieu Chandi,  Ao Phong Nam Hoa Tiet Tre Trung Chat Lieu Cotton Cao Cap Mat Min Tham Hut Mo Hoi Mau NT5051",129000,129000,5,15,22
0,0,Ao thun ba lo nam chat vai cotton 100% thoang mat co gian,28000,28000,4.2,10,123
81000,45,"Ao thun nam co tron HAHAMAN vai Cotton co gian,day dan cao cap CT06002",180000,99000,5,27,36
71000,42,"Ao So Mi Nam Dai Tay Chat Lieu Chong Nhan, Phong Cach Han Quoc",170000,99000,4.1,69,832
111200,44,"Ao khoac nam JJ01 , khoac du nam 2 lop phoi non khong thao roi thoi trang han quoc tre trung cuon hut Julido mau TT01 chat lieu tham hut mo hoi day dan mac thoang mat",250200,139000,4.3,68,158
0,0,Ao Khoac Du Nam Co Dung Tui Khoa Keo Han Quoc BONADO BAK29,169000,169000,4.3,292,4039
0,0,Ao HOODIE POKA Unisex - K79,178000,178000,5,2,
0,0,Ao so mi caro unisex nam nu in hinh hoa tiet hai tay moi nhat,149000,149000,4.5,193,751
0,0,"Ao So Mi Nam Dep,Cao Cap MON Boutique TS001",125000,125000,4.6,16,29
0,0,Ao Khoac Bomber Ni Ngoai Sieu Day Ao Khoac Unisex Form Rong Nam Nu Mac Cuc Chat ,95000,95000,5,2,3
71000,42,Ao So Mi Nam Dai Tay KOJIBA - Mau Den Tron,170000,99000,4,95,856
0,0,Combo 3 Chiec Quan Lot Nam Tam Giac Chat Lieu Cotton Cao Cap CALUCI CA - 01 (Giao Mau Ngau Nhien) - Hang Chinh Hang,360000,360000,4.5,28,45
0,0,Quan Jean Baggy nam den+ xanh sky rach gau+ goi style han quoc 2021,0,179550,5,8,
180000,26,Ao Khoac Gio 2 Lop (5AG2T004) Co Mu Chat Polyester Chong Nuoc Nhe Giu Nhiet Tot Hang Cao Cap Chinh Hang Biluxury,699000,519000,4.3,6,13
87000,47,Quan Lot Nam Jockey Trunk Ban To Thun Cotton Bamboo Mau Xam - JUMB0418,185000,98000,4.5,10,61
0,0,AO KHOAC BOMBER NAM CHAT LIEU DU CAO CAP THOI TRANG NAM 2021,245000,245000,4.7,12,35
0,0,Ao phao nam ao khoac phao cho nam thoi trang,255000,255000,4.5,36,53
0,0,"Túi dụng vest nam, túi bảo quản vest nam giá rẻ màu den giúp quàn áo bèn màu luon mói",847000,847000,4.7,3,
59000,50,Ao phong nam nu unisex tay lo thun form rong teen co tron oversize cotton gia re basic den trang tee ulzzang VIET NAM FANTASTICI ,118000,59000,4.6,5,7
75000,50,"Bo do nam y hinh, vai em, mat, khong ra mau, khong do long (oppose)",150000,75000,4.2,24,63
0,0,"Quan Tay Nam, quan tay au phom han quoc dang om ong con, vai co dan. Hinh that 100% chat vai tuyet mua day min dep loai 1 chuan shop.",85000,85000,3.7,7,23
59000,50,"Ao thun nam dai tay co tron mac thu dong, giu nhiet, chat cotton co gian, dang om, nhieu mau lua chon, khong bai xu, giat duoc may giat",118000,59000,4.3,6,38
0,0,Quan Jogger KaKi Nam Co Gian 4 Chieu Kieu Dang The Thao M02,49000,49000,1,1,
0,0,QUAN TAY NAM CO GIAN CAO CAP DN20010510 - den - 30,86000,86000,3,2,18
159200,44,"Quan Jean Nam cao cap chat bo sieu co dan Thuong Hieu Chandi, form dung dang dep mau moi sieu hot 2021 MR9073",358200,199000,4.8,42,91
88000,37,Ao Len Nam 5 Mau Tron Phong Cach Tre Trung Lich Lam Thoi Trang VICERO,238000,150000,4.3,43,253
60000,47,Mieng Don Quan Lot Nam Desmiit,129000,69000,5,7,121
71000,22,Ao so mi nam tay ngan ADINO mau trang tinh vai soi soi modal dang slimfit tre trung CT102,320000,249000,5,3,3
0,0,Set 5 Quan Short nam chat lieu cotton hoa tiet ke caro,489000,489000,0,0,
111200,44,Quan short jean nam B1111 co dan kieu dan tre trung don gian theu hoa tiet Julido thoi trang han quoc,250200,139000,4.6,71,165
0,0,Combo 5 Chiec Quan Short Nam Cotton Hoa Tiet ke Soc Caro Tre Trung,105952,105952,0,0,
0,0,Ao Khoac Du Nam Nu Kieu Bomber Theu TM 21 Unisex Form Rong ,95000,95000,4.5,4,12
0,0,"Quan Sip Nam Chu V Nang Mong Sieu Thoang K367 - Den,L",62000,62000,0,0,11
0,0,"Combo 4 Quan Sip Nam Quan Lot Dui Nam Boxer Thun lanh Mem Min Sieu Thoang Mat, Co Gian 4 Chieu Cao Cap",99000,99000,4.6,26,48
0,0,Ao len dai tay nam thoi trang Han Quoc SAL212,209000,209000,4.5,17,70
0,0,Bọ Nam Thu Dong bọ nam Chũ Z chát nỉ bong cao cáp phong cách hàn quóc,247000,247000,3.7,3,4
0,0,quan dui nam mac nha vai thun min mac thoai mai nhe nhang size duoi 65kg,35000,35000,5,7,48
0,0,"Quan dui thai, quan nam mac o nha",26000,26000,3.4,5,49
0,0,Ao thun sat nach WIND unisex form rong STICH ba lo nam nu oversize cotton ulzzang,70000,70000,4.3,3,7
0,0,"Ao thun Nam Nu Khong co GAU TRUC PU PO CIMT-0012 mau moi cuc dep, co size be cho tre em / ao thun Anime Manga Unisex Nam Nu, ao phong thiet ke co tron basic coc tay thoang mat",39999,39999,5,2,7
0,0,"Ao Thun Nam_ Nu  Phan Quang In hinh CHO SOI , ao chat, di dem, di phuot bao ngau, nhin da mat",60000,60000,5,10,28
0,0,"Ao Thun cho ca Nam va Nu Phan Quang In hinh DI DUONG QUYEN , ao chat, di dem, di phuot bao ngau, nhin da mat",60000,60000,3.7,6,15
0,0,AO BA LO NAM COTTON NANG DONG CO SIZE 3XL,139000,139000,1,2,2
159000,50,Ao polo nam ADINO mau do phoi vien chim vai cotton co gian dang slimfit tre trung nang dong AP84,318000,159000,5,4,7
0,0,Ao thun Teeworld Toi la nguoi Sai Gon,329000,329000,4,2,3
111200,44,"Do Bo The Thao Nam thuong hieu Chandi, Do Bo Mac Nha chat lieu thun cao cap mat me, tham hut mo hoi tot MS904",250200,139000,4.6,5,28
0,0,AO KHOAC KAKI NAM QUANG CHAU TUI HOP -LOT LONG CUU SIEU DAY CHO MUA DONG,230000,230000,3.3,8,20
150000,46,Quan short nam the thao chat thun cao cap mem min co dan 4 chieu,325000,175000,4.7,7,15
0,0,"Quan Short Jean Nam, Quan Bo Ngo Nam Cao Cap Mau Moi Sieu Dep OBOK Fashion QSN1006",149000,149000,4.5,6,16
99000,50,Quan short nam nu unisex tui hop chat vai kaki co gian cuc ngau (Sphatsang) ,198000,99000,4.8,5,17
0,0,"Combo 4 quan sip dui nam, quan lot Boxer hoa tiet tre trung, nang dong - MAU 1",99000,99000,5,2,5
0,0,"Hop 4 quan Boxer thong hoi Nhat MUJI (hang dep, chinh hang)",75500,75500,4.3,3,10
0,0,AO SO MI NAM CO TRUONG TAY NGAN _ PHONG CACH ,165000,165000,3.7,6,44
0,0,Ao so mi dai tay nam den tron  - BDT,99000,99000,4.5,10,19
61000,41,Quan thun nam ngan quan dui mac nha thoang mat co tui rong TKQDCR02 PigoFashion giao mau ngau nhien,150000,89000,5,3,24
0,0,Ao giu nhiet nam ao the thao dai tay nhieu mau,63000,63000,2.5,2,5
0,0, Quan dui shorts 2in1 bo dui trong Pmax mau hot hit,129000,129000,4.8,18,30
0,0,Ao len nam co tron cao cap hot 2021,149000,149000,5,2,4
0,0,"Ao Thun Nam_ Nu  Phan Quang In hinh MAT MANG , ao chat, di dem, di phuot bao ngau, nhin da mat",60000,60000,5,7,15
70000,20,Ao so mi nam tay dai ADINO mau trang kem hoa tiet theu co vai soi soi modal dang slimfit tre trung S149,350000,280000,5,2,2
0,0,Quan Ni Nam Bo Ong Day Dan,199000,199000,4.3,3,17
0,0,Ao khoac kaki nam 2 lop co non SITAKI thoi trang cao cap AKK15,175000,175000,4.2,29,60
0,0,Combo 4 chiec quan sip dui boxer chat thun bong tham hut mo hoi ,98000,98000,4.6,7,27
80000,44,"Ao thun nam co be tay ngan tre trung, chat lieu cotton cao cap mau THUU50",180000,100000,4.5,18,44
0,0,Ao khoac Jeans Nam Unisex phoi non Caro soc do cao cap,194000,194000,4.7,18,39
0,0,COMBO 3 QUAN LOT NAM COTTON CAO CAP thoang khi khu mui SP-2899,195000,195000,4.8,10,27
26700,10,Ao Khoac Ni Hoodie Logo Color 2 Lop Day Dan Cotton Phong Cach Han Quoc Thoi Trang Nam Nu Free Size Duoi 70kg KNN34,267000,240300,4.5,2,4
0,0,Ao Thun Nam In Phan Quang Hinh Monster ,77000,77000,4.5,152,383
0,0,AO KHOAC NHUNG NAM BOMBER UNISEX ,150000,150000,3.8,4,6
0,0,AO THUN NAM DAI TAY PHOI SOC NGANG ,149000,149000,3.7,6,22
0,0,AO KHOAC KAKI NAM KIEU DANG HAN QUOC,239000,239000,4.5,2,7
0,0,"Ao thun nam tay lo YINXX, ao phong form rong ATL188",69000,69000,5,11,19
0,0,Ao khoac du nam 2 lop theu N,85000,85000,4.5,14,26
0,0,QUAN SHORT NAM KAKI HAN QUOC,167700,167700,4,7,16
0,0,"Ao Thun, Ao Phong Nam The Thao Unisex Cotton Form Rong Tron Basic Co Dan 4 Chieu In Chu Cao Cap Big Sport ",138000,138000,4.6,22,60
89000,50,"Combo 3 ao ba lo nam tu 55-68kg, ao om body , ao thun tap gym chat thun lua mac cuc mat giao mau va mau ngau nhien ",178000,89000,5,1,6
79200,44,"Quan short nam mac ngu Julido, Chat dui mem chinh pham mac mat thoai mai MMO01 ",178200,99000,3.5,67,280
0,0,[Size chau au] Quan sip boxer khang khuan Han Quoc,37000,37000,4.5,37,82
0,0,Ao Thun Ba Lo Nam Phong Cach Han Nhieu Mau,75000,75000,4.8,9,19
0,0,"Ao somi tay lo kaki unisex Wind Quoc Dan hoa cuc, ao somi tay lo Ulzzang Wind",109000,109000,5,3,9
75000,50,"Set Bo the thao nam y hinh, vai em, mat, khong ra mau, khong do long (ydbid)",150000,75000,3.1,27,66
0,0,Ao Thun Tay Lo Unisex TOKYO DRIPPING WASHED 100% Cotton - HADES Brand Chinh Hang,420000,420000,5,3,6
0,0,Ao Khoac Du THIFU FASHION 2 Lop In CYM TM Chong Nang Tranh Mua Cho Nam Va Nu,99000,99000,2.5,2,2
31000,18,Do bo nam dui THE 1992 Bo dui nam co tau cao cap,170000,139000,4.5,7,24
0,0,"Ao thun nam nu tay lo YINXX, ao phong form rong ATL08",49000,49000,4.8,4,12
0,0,Combo 5 Quan Sip Dui Boxer - Quan Lot Nam,89000,89000,3,1,9
0,0, Ao thun nam tay lo form rong Stay Real 69,84000,84000,2.3,19,40
91000,26,Ao so mi nam tay dai ADINO mau trang tinh vai soi soi modal dang slimfit tre trung S302,350000,259000,5,4,8
0,0,Quan lot nam - Combo 4 quan sip dui nam thoang mat,177000,177000,5,16,48
0,0,Ao Khoac Jean Nam AKB3,120000,120000,5,2,3
60000,47,Bo quan ao thun ba lo nam the thao Everest,129000,69000,4.5,7,23
0,0,Ao Hoodie Among US [ HANG MOI VE ] TRUST NO ONE Mau Den Hinh Xanh Co Non Chat Vai Ni Bong Day Dan Mem Min Am Ap Form Dep Danh Cho Ca Nam Va Nu,153000,153000,4.5,10,35
0,0,Combo 2 Quan Dui Nam JME JMB003 (Freesize),99000,99000,4.5,5,34
0,0,Ao So Mi Den  Ao So Mi Nam nu unisex,0,140000,4.5,4,
0,0,"Quan ni bong nam vai bong mem min, day dan ",49000,49000,0,0,2
0,0,"Ao khoac jean nam King168 , ao khoac bo cao cap AK20",199000,199000,5,1,3
0,0,Hop combo 5 sip dui boxer SQB101 BLACK,219000,219000,4.7,28,121
0,0,Ao Hoodie Ni luc giac 4 mau ( unisex nam nu deu mac duoc),89000,89000,4.5,12,22
0,0,Ao So Mi Nam SM46,195000,195000,5,1,1
0,0,"Do Bo Mac Nha Dao Pho FREE SHIP Ao Thun Ba Lo Nam In HARBOUR PARIS Sieu Dep, DO BO CHAT LIEU THUN LANH IN 3D USA, HARBOUR PARIS MAC O NHA, DAO PHO SIEU CHAT CHO MUA HE, Bo Do The Thao Ba Lo Nam , Dao Pho, Do bo nam, Bo do Nam The Thao Sat Nach Phong Cach Nang Dong, Do bo nam tap gym, set quan ao the thao nam nu mac nha Unisex 3 lo phong cach Ulzzang in chu HABOUR",90000,90000,4.6,12,35
0,0,Ao Khoac Da Nam Tran Bong Ao Khoac Nam Co Mu Co Dai Sieu Am Sans11 Sans Shop,0,790000,4.5,2,
0,0,Combo 3 Ao phong thoat nhiet Nhat Ban Goking,435000,435000,4.6,61,196
0,0,Quan short kaki nam lung thun size 28-34,59000,59000,4.5,30,92
0,0,"Ao Phong Nam Cao Cap,Sieu Dep M.O.N Boutique HSO01",125000,125000,4.3,3,3
61000,41,Do bo nam THE 1992 Bo the thao nam KEEP TRAINING,150000,89000,5,6,33
111200,44,"Ao so mi nam lua soc caro Julido Store, xu huong moi nhat nam 2020 BZ03",250200,139000,4.8,12,27
185000,50,"Quan Dui Nam GUZADO,Chat Thun Lanh Cao Cap, Mem Min, Co Gian 4 Chieu, Khong Nhan Nhau,Van Dong Thoai Mai GSR05",370000,185000,4.1,7,22
110000,50,COMBO 3 ao lot nam thun cotton - Ao ba lo - Ao coc tay nam thun cotton mac cho cho nam gioi chat mem mai,220000,110000,1,1,4
0,0,Quan Jogger Unisex  Quan Ong Rong- Quan Dai The Thao Nam Nu Chat Vai Umi Xin Min,114000,114000,4.5,5,10
0,0,Ao thun nam tay dai,125000,125000,4,22,68
0,0,Ao So Mi Flannel So Mi Caro Ao Khoac Nam Nu Form Rong Ca Tinh Unisex SM11,110000,110000,5,2,10
0,0,Ao Khoac Nam Cardigan Nam Len Cao Cap Thoi Trang SZone SAL219,249000,249000,4.5,24,61
0,0,ÁO KHOÁC HOODIE NAM FORM RỌNG CÓ NÓN LÓN CỤC DẸP,0,109000,3.6,10,
61000,41,Jogger ni THE 1992 Quan the thao nam basic 3 mau,150000,89000,5,7,21
74000,40,Ao So Mi Nam Body Tay Dai Hoa Tiet 3D Chat Lieu Kate Thai Sang Dep Cao Cap,184000,110000,4.8,4,19
0,0,Hop 3 Quan sip Dui Nam Soi Nano Khang Khuan Thoang Mat Tham Hut Mo Hoi 3A,45986,45986,5,2,4
0,0,Hop 4 quan Lot nam Nhat MUJI thong hoi dep (chinh hang)(gia re),69000,69000,4.5,4,8
300000,33,Ao Khoac Nam Kaki Lot Long Sieu Am Thoi Trang Linh,899000,599000,4.6,29,58
0,0,Quan sip nam xuat EU thun lanh khang khuan cao cap TG,8500,8500,4.8,8,111
0,0,Ao thun Teelab Pixel Logo TS135,350000,350000,4.5,2,2
0,0,Combo si gom 5 quan lot dui nam xuat nhat - quan boxernam ,150000,150000,4.5,2,5
0,0,Ao thun polo nam ngan tay co co co tui trung nien coton cao cap vai cotton Thai Khang,79200,79200,4.5,17,51
221000,61,Quan Short Nam Kaki Phong Cach Thoi Trang VICERO,360000,139000,4,109,471
0,0,Ao mong to ghi nam trung nien chat vai cao cap sieu dep sieu dep,199000,199000,4.5,12,35
263000,50,Quan short jean nam GUMAC QJNB6107,525000,262000,4.7,10,18
210600,45,Quan Kaki Nam Khatoco Q2M468R1-VNMA013-1811-1 - Xanh Dam,468000,257400,4.5,51,242
0,0,Ao thun nam tay ngan co co trung nien CAO CAP hang nhap khau bao xin loai ao thun cho nguoi lon tuoi caro soc ngang,220000,220000,5,9,28
94000,35,Ao thun nam GUMAC ATNB834 in tai nghe,270000,176000,4.6,5,5
111000,48,"Ao Thun Nam Co Tim  (5APKB001XNG) Chat lieu Cotton Cao Cap Thoang Mat Kieu Dang Body Fit Tre Trung,Nang Dong Chinh Hang Biman By BiLuxury",230000,119000,4.7,3,4
50000,27,"Ao Thun Nam Tron Co Tron Body Tre Trung Nang Dong, Soi Cotton Cao Cap Mem Min Thoang Mat Tham Hut Mo Hoi, Co Gian 4 Chieu MRM FASHION",185000,135000,4.5,28,97
237000,60,Ao thun polo nam co tru bo soc GUMAC ATNB399,396000,159000,4.8,6,16
0,0,"VARDINO ao khoac nam cao cap co be - co dung, tron - hoa tiet, mem - min - nhe - khong nhan - khong phai - chong nuoc chinh hang dang xuong - om vua - vat bang cong so trung nien moi ak06",895000,895000,4.3,13,24
0,0,Quan jogger ni nam ong rong bo chun gau vai thun da ca co gian - QUAN SM002C,69000,69000,4.1,11,29
173000,51,Bo Mac Nha The  Thao Nam Mua He Thun Mong Cao Cap ZERO - BTT18 XANH THAN - XXL,338000,165000,4.6,8,17
0,0,AO THUN NAM DEP TAY DAI VAI COTTON,149000,149000,4.5,24,44
0,0,"Ao thun tay lo Unisex, ao phong form rong ATL206  - Yinxx",69000,69000,5,11,18
26000,21,Ao Thun Nam Co Co Simple Cao Cap ShopN6 - AT01 (Nhieu Mau),125000,99000,4.3,7,18
237000,60,Ao thun polo nam tay phoi mau GUMAC ATNB397,396000,159000,4.8,14,32
135000,45,Bo Quan Ao Nam The Thao Vien Tay Cao Cap thoi Trang ZERO,300000,165000,4.5,17,34
0,0,Combo 5 Quan Lot Nam Thun Lanh Cao Cap Ma S03,150000,150000,3.7,3,5
0,0,Ao so mi nam dai tay dang om so co be vai lua thai co dan chong nhan chong xu loai ao so mi dai tay body ASLD10,79000,79000,4.7,6,8
90000,41,"Ao So Mi Rong Co Vest, So Mi Rong Tay Dai Unisex Nam Nu Vai Lua Nhieu Mau Sac",220000,130000,5,2,3
77000,31,Ao Khoac Nam Ao Khoac Kaki Nam Don Gian Cao Cap-KK34,245000,168000,3.2,38,174
0,0,BO DO NAM DAI NI COTTON DEP,269000,269000,4.1,15,29
102000,42,Ao Khoac Nam Ao Khoac Du Day Nam Tron  Lot Caro Cao Cap ShopN6 - AD34,245000,143000,4.5,503,2542
0,0,"Ao thun nam thoat nhiet Nhat Ban GOKING, chat lieu tu nhien 100% cotton thoang mat, tham hut mo hoi",159000,159000,4.8,133,539
0,0,Ao giu nhiet nam - ao thun nam dai tay,100000,100000,4.6,9,35
54000,18,Ao Khoac Ni Nam Co Mu Ran Ri Quan Doi Lot Long Cao Cap,299000,245000,4.8,5,27
0,0,Quan jogger the thao nam kaki ma TT33-Q tui hop bo ong phong cach Han Quoc chat vai dep ong dai,79000,79000,1,2,2
98000,25,Combo 3 quan dui nam cotton iBasic SHM001,387000,289000,4.5,4,6
224000,50,AO PHONG NAM LOCAL LOOSE TU QUAN,449000,225000,5,3,3
0,0,Combo 5 chiec Quan lot Boxer nam SQB200,114000,114000,3.8,4,4
150000,35,Ao Khoac Da Nam Den Lot Long Cao Cap ShopN6 AKD06,425000,275000,4.7,10,23
102090,41,Ao phong nam tay lo from rong mau den in decal VINHCUU,249000,146910,4.8,12,23
89790,41,Ao Thun Nam Tay Lo Unisex co Tron chat lieu vai cotton mau den form rong in chu PARIS phong cach doc chat TheNgaustyle,219000,129210,5,4,4
236000,48,Quan tay nam Novelty 0Ply 1811100 xanh tim Form SlimFit,495000,259000,5,4,15
36000,20,Quan boi nam cao cap Narsis Q0004 mau ke den,180000,144000,4.6,15,40
97110,39,Ao thun Tay lo Nam Nu Form Rong In decal Nhat Ban 3 mau trang Trum Unisex vai cotton thich hop di choi,249000,151890,4.5,5,12
0,0,Quan Jean Nam Wash Bac Dang Om JEANBAC01,109000,109000,0,0,
0,0,Quan Nam Tron Bo Gau Basic Phoi Day Rut Phong Cach Tre Trung Thoi Trang Zenkonu QUAN NAM 1000067V1,59000,59000,3,3,23
112000,36,Ao Phong T - Top Nam Jockey Thun Cotton Compact In Haft Boy Mau Xanh Bien Nhat  Cao Cap - J7339,310000,198000,5,3,8
0,0,"Combo 3 quan sip dui nam, set 3 quan lot boxer nam Aristino chat lieu Modal cao cap khang khuan, khu mui, mem mai thoang mat gap 2 lan so voi soi vai thong thuong ABX1616",330000,330000,4.5,2,15
0,0,"Quan tay nam chat vai day dan co gian nhe, quan au dang ong con, nhieu mau - NH Shop",49000,49000,0,0,9
0,0,AO KHOAC DA NAM FORM CHUAN DEP,190740,190740,5,5,12
0,0,AO THUN TAY LO UNISEX,48800,48800,4.2,28,95
0,0,Quan Jean Nam Den Dang Om Chat Co Gian JEAN01,125000,125000,4.3,212,638
87000,47,Quan Lot Nam Jockey Dang Trunk Boxer Thun Bamboo Thoai Mai Thoang Khi - JUMB0420,185000,98000,5,5,23
104000,36,Ao thun nam co tron cao cap ngan tay dep chat vai cotton co gian 4 chieu thoang mat ZAVAS  Z06,289000,185000,4.8,4,13
127200,44,"Quan jean nam dep dan dau xu huong Julido, mau moi form dep ton dang khong qua om mau EQ03",286200,159000,4.7,23,49
0,0,Quan Ngo Nam Ong Rong Alibaba - Quan Short Nam Vai Dui,39000,39000,2.3,3,9
260000,44,"Quan Jean Nam 5S (QB5S001DEN) Den 1, Dang Om Tre Trung, Nam Tinh",589000,329000,4.6,218,539
115000,38,Ao khoac jean nam HAHAMAN thoi trang cao cap AKJ005,300000,185000,3.8,4,7
71000,42,"Quan Jogger Kaki KOJIBA Phong Cach The Thao, Tre Trung ",170000,99000,3.3,99,1671
0,0,"Bo quan ao dui nam bo do nam vai dui mac cuc me voi chat vai xop nhe , thoang mat tham hut mo hoi",108000,108000,4.1,16,53
0,0,Quan Baggy jean nam ong suong rong style han quoc 2021,0,169000,4,6,
0,0,"Quan Jean Nam Vovesa Mau Moi, Dang Om Tre Trung, Nam Tinh Q5",99000,99000,3.8,5,14
0,0,"Ao thun Nam Nu Vonesa, ao phong Unisex Nam Nu co Size tu 25-84kg B2",45000,45000,5,3,3
0,0,Quan Jean Bac Phong Cach Tre Trung JEANBAC02,99000,99000,4.5,42,151
0,0,"Ao thun polo Vai ca sau chat xin, co vien co tre trung, lich lam hang xuat cao cap",69000,69000,4.5,31,63
0,0,AO KHOAC PHAO NAM PHOI NON TRAN LONG VU BA LOP THOI TRANG PT09,150000,150000,2.5,4,9
0,0," (co video)AO KHOAC GIO THU DONG 2 LOP PHOI MAU DI MUA,CAN GIO, CHONG NANG DA NANG (HD7404)",149000,149000,4.5,102,334
179000,60,Ao Thun Nam Co Co Dep Tron Cao Cap Tay Ngan Polo ZERO,298000,119000,4.3,12,113
0,0,Áo Thun Unisex Bad Rabbit Club Den 100% Cotton - Local Brand Chinh Hang,340000,340000,4.6,5,10
0,0,Ao khoac nam gia Vest chat Cotton dang slim vua van tre trung - XAM CARO,550000,550000,4,7,19
70000,31,Ao the thao Quickdry Cool247 thuong hieu Coolmate,229000,159000,5,8,19
0,0,(ANH THAT) Ao thun nam nu fom rong Unisex in hinh Rong den trang vai thun mem min thoang mat tham hut mo hoi,75000,75000,5,10,38
189000,50,Ao Len Ke Ngang 5 Mau Nang Dong Thoi Trang VICERO,378000,189000,4.2,5,10
0,0,Ao so mi nam mau den tay ngan,98000,98000,4.8,12,49
0,0,Ao thun tay lo HADES - NONSENSE BLACK,350000,350000,5,2,5
0,0, QUAN DON MONG NAM VA DON DV NAM 2 TRONG 1 KIEU BOXER QSHOP QN27 QN33,180000,180000,5,9,37
0,0,Quan Sip Luoi Nam Mong Mat Sexy K165,60000,60000,4.5,27,82
0,0,Ao thun tay lo form rong theu hinh vuong - Unisex nam nu deu mac duoc,79000,79000,4.5,19,36
0,0,quan jean nam cao cap co gian loai quan jean xuat khau form chuan,249000,249000,4.3,12,28
59000,50,Ao thun nam nu unisex tay lo phong form rong teen co tron oversize cotton gia re basic den trang tee pull STRADA,118000,59000,5,6,22
0,0,Hop 4 Quan Sip Dui Thong Hoi Cho Nam,89000,89000,4.5,7,38
0,0,Quan Jean Nam Den Chat Co Gian JEAN51 - Jean,134000,134000,4.5,38,97
100000,44,Quan Lot Nam,229000,129000,4.5,25,371
0,0,"AO LOT TAY NGAN COTTON CATRIO LA AO THUN, AO PHONG, AO NGAN TAY CUA NAM TU 50KG DEN 83KG thuoc do mac di ngu, mac o nha, mac lot ben trong ao so mi, vai 100% cotton an toan ",65000,65000,5,8,90
0,0,Ao Khoac Nam Nhung Tam Lot Long Cuu K13 am ap gia dep,440000,440000,4.5,6,34
127200,44,"Quan jean nam co dan 4 chieu chat jean xin Julido, mau moi form dep ton dang khong qua om mau kV2212",286200,159000,4.3,62,119
5000,8,"Quan dui nam thun cotton mac ngu thoai mai, chat luong loai quan dui nam mac ngu hoa tiet (Giao mau ngau nhien)",59000,54000,3.6,12,198
0,0,Chenille ao len nam nua cao co ao len cashmere moi mua dong am ap,290000,290000,5,6,25
299000,50,Ao Khoac Nam Bomber Hai Lop Tran Long Chat Vai Nhung Tam VICERO,598000,299000,4.6,12,26
0,0,Ao Khoac Ni Bomber Nam Nu Form Rong Unisex Chat Ni Ngoai Day Dan Cuc Hot (chucuu),95000,95000,4.8,5,16
70000,36,"Quan lot boxer nam AKUBA vai soi Modal tu nhien (go soi), khang khuan, co gian thoai mai, tham hut tot 01U0013",195000,125000,4.5,5,6
0,0,"Ao Sweater , ao thun dai tayi 5 MAU NI NGOAI FORM RONG OVERSIZE (Unisex nam nu deu mac duoc)",78000,78000,4.3,28,81
100000,50,"Áo khoác gió bomber nam nũ Tori local brand chát dù 2 lóp form rọng, khoác ulzzang unisex, Ao Khoac Du Bomber Jacket Toricndy  2 Lop Unisex,Ao khoac Bomber Du TORIC Ulzzang Nam Nu Unisex Form Rong",200000,100000,4.5,2,4
0,0,"Quan Dui Nam Chat Vai Dui Thai Thoang Mat,Quan Short 3 Mau Mua He Nang Dong",39000,39000,0,0,2
0,0,"Quan jean nam dai cao,vai co gian, ong suong cao cap",258700,258700,1.5,2,3
51000,34,Quan The Thao Thu Dong Nam Ong Suong Phong Cach Han Quoc Nang Dong 24,150000,99000,5,2,2
0,0,Ao so mi nam jean dai tay Ma A657 len form cuc chuan,169000,169000,4.3,3,5
0,0,quan short thun day keo,89000,89000,2.6,5,18
0,0,Combo 2 Ao Thun Trang mac nha ( Hanosimex),101400,101400,2.3,3,4
34000,29,QUAN NGU NAM THUN 100 % COTTON FEZZIO - NAVY THUY THU - XL,119000,85000,5,2,8
0,0,Combo 2 quàn dùi nam cotton co giãn 4 chièu,129000,129000,4.3,17,95
120000,44,"Ao Thun Nam Cotton in hoa tiet 2 mau trang den thuong hieu Julido Store, ao phong co tron basic coc tay thoang mat, tham hut mo hoi - Hang chinh hang AT04",270000,150000,4.5,33,66
0,0,Quan Jogger Kaki Nam ND03,219000,219000,4.5,67,386
26000,50,Ao Phong Nam Trang Tron Chat Cotton Mat THUNTRANG59 - Thun Trang,52000,26000,4.7,3,53
0,0,Ao thun Teeworld UA Version 2 T-Shirt Nam Nu Form Rong Unisex,329000,329000,5,3,4
91000,48,"Quan short nam GUZADO, Chat vai gio mem, Co gian Cuc Tot, Van Dong The Duc The Thao Thoai Mai GSR02",190000,99000,4,8,39
0,0,Ao 3 Lo Nam Chat Vai Det Kim Co Dan 4 Chieu Thoang Khi Tham Hut Mo Hoi Tot Big Sport,118000,118000,3,3,9
99500,50,"Ao So Mi Nam Tay Dai  Tron Cong So Phom Slimfit  Vai Cotton 100% Cao Cap Mem Min, Thoang Mat  TUTO5 ASM1001",199000,99500,4.7,84,372
31000,12,Ao khoac du gio nam chong nuoc xep thanh balo dung do TKAKD902 PigoFashion,250000,219000,4.1,7,21
0,0,Quan lot nam ho suon Hunk American Jock mau do,129000,129000,4.8,16,31
0,0,"Quan Lot Nam Vai Thong Hoi Cao Cap,Quan Sip Tam Giac Chat Co Gian 4 Chieu Mac Thoang Mat",18500,18500,0,0,3
0,0,Quan jean nam rach goi hinh that_Quan bo dep ms 9600,112000,112000,5,2,
0,0,"Set 2 Ao phong nam thoat nhiet Nhat Ban Goking, ao thun nam sieu mat, mac nhu khong mac, tham hut mo hoi 01",288000,288000,5,8,31
90000,31,Ao phong nam co tron cao cap ngan tay dep chat vai cotton co gian 4 chieu thoang mat ZAVAS  Z01,289000,199000,5,4,8
0,0,"Ao nam thu dong,phong cach Han Quoc,tre trung nang dong,full size den 85kg - Ma SP3",171000,171000,5,4,6
0,0,Ao thun nam form tre trung vai thun mem mat free size duoi 65kg,24700,24700,3.7,15,72
0,0,Combo Ao + Mu Ao thun coc tay mau den in hinh Rank thach dau game Free Fire tang non luoi chai theu cao cap,109000,109000,4.3,34,89
0,0,"Combo 4 quan lot nam sieu thoang mat, co dan 4 chieu, quan lot luoi nam",169000,169000,4.2,6,14
0,0, Ao khoac dang vest co be nam trung nien QA013,560000,560000,4.7,3,9
0,0,"Ao khoac du nam GOKING mu dau sau co, chong nang, di mua, can gio tot. Cong nghe Nhat Ban",255000,255000,4.5,28,55
0,0,"Quan Short Gio Nam, Quan Dui Thun Nam Mau Xanh Den Chat Vai Du Thoang Mat Full Size Cao Cap Big Sport",129000,129000,3.7,10,39
144000,44,"Quan Short Jean cao cap co dan tot Thuong Hieu Chandi, phong cach han quoc mau moi nhat 2021 MR8014",324000,180000,5,19,21
0,0,"Ao phao nam, Ao khoac phao nam kieu dang han quoc mu lien",210000,210000,3,2,10
0,0,Ao so mi denim nam tay dai hai tui cong so trang vai jean cao cap tre trung nien Nexx&Dee SM10,249000,249000,4.8,4,5
0,0,Ao thun Teeworld Ua em Tay Lo Nam Nu Form Rong Unisex,299000,299000,4.8,4,8
71000,44,Combo 5 Quan Sip Dui Nhat - Quan Lot Nam Thun Lanh,160000,89000,4.8,5,13
0,0,Quan jean nam ong suong Muidoi Q63 (Xanh dam),129000,129000,4,60,179
0,0,"Ao Varsity nam cao cap Miuzi,ao khoac ben ngoai nam hoa tiet set dinh da cach dieu DT032",319000,319000,1,2,2
111200,44,"Ao so mi nam Julido JL30, chat lua khong xu ton dang form chuan mau da dang",250200,139000,4.3,6,15
0,0,"Ao khoac gio trang bac lot long cho nam nu,  chong nuoc hang cao cap, ao lot long giu nhiet mac sieu am cho mua dong - PDV55",400000,400000,5,9,22
0,0,Ao Thun Nam Trung Nien Tay Ngan Co Co Day Mem Sieu Mat Freesize Duoi 75kg Loai Nhieu Hoa Tiet,27000,27000,3.5,4,13
0,0,"Ao Polo Nam Trung Nien Co Tui ,thun phoi cao cap from chuan, thiet ke phong cach sang trong, xuat xin JD30",159000,159000,5,2,8
0,0,Ao Thun Unisex,67000,67000,0,0,
0,0,QUAN LOT NAM thun lanh 6042(FREEMAN) ,41250,41250,4.6,21,57
0,0,Ao thun dai tay Nomac Unisex AT0728 hinh gau/ Freesize/ Phu hop ca nam va nu.,63000,63000,4.6,44,80
0,0,Ao Thun Nam Dai Tay Unisex. Ao thu dong tron tay dai co tron basic vai Poly 2Da N04,149000,149000,2.3,3,8
0,0,Hop 5 Quan lot (Quan sip) boxer nam Dua,219000,219000,4.5,39,171
0,0,QUAN SHORT AU NAM - Den - 29,135000,135000,0,0,19
111200,44,"Ao khoac nam JJ07 , khoac du nam 3D 2 lop phoi non khong thao roi thoi trang han quoc tre trung cuon hut Julido mau THU38 chat lieu tham hut mo hoi day dan mac thoang mat",250200,139000,4.8,28,96
0,0, Quan Dui Au Nam Cao Cap-QD41,79000,79000,4,9,49
0,0,Quan Ni Nam Jogger (HE-DONG),50000,50000,3.7,25,92
0,0,"quan jogger, quan the thao nam, quan nam dai, quan nu dai, quan the thao nam nu deu mac duoc, quan thun nam nu, quan thun dai, quan phat sang ban dem, quan du nam nu",80000,80000,4.3,7,16
0,0,Quan Shorts  KAKI Nam lung thun co dan,59000,59000,4.2,5,21
0,0,Ao da nam dang dai co dai,415000,415000,4,2,8
0,0,"Quan jogger tui hop chat kaki min, dep, cuc ngau ",79000,79000,4.3,3,5
0,0,Set Bo 3 Lo Nam USA Mac Dep Thoai Mai Ngay He GDF5,98000,98000,3.6,29,57
0,0,Ao Sweater Nam Nu Form Rong - ni chui thuong khong non,76000,76000,4.5,8,20
39000,50,"Ao Khoac Ni, Ao Khoac Nam Coffee SW02",78000,39000,1.2,7,8
0,0,"Ao thun nam, ao phong co co bigsize tu 45kg den gan 90kg - NH Shop",39000,39000,0,0,10
0,0,AO THUN NAM DAI TAY CAO CAP CO GIAN TOT,149000,149000,4.5,16,37
0,0,Ao thun nam unisex  phong rong hoa tiet sieu hot (UX-2004),39000,39000,4.5,5,17
0,0,"Quan Short Dui Nam Mantinovn, Quan Ngo Nam Chat Dui Mac Quan Dui Nam Chat Thoang Mat Dang Tre Trung",156000,156000,3.4,7,17
0,0,"Combo 4 quan dui nam mac ngu King168, Chat dui chinh pham mac mat mau TOP2",0,250000,3.7,3,
0,0,{SIEU PHAM MUA DONG} AO KHOAC NAM/AO KHOAC PHAO NAM TRAN BONG 3 LOP SIEU AM AP MUA DONG CO SIZE 3XL THOI TRANG MOI KINGS,150000,150000,3.5,6,20
0,0,"Ao One Piece Zoro ATT-02, Ao thun Anime Manga One Piece Ronoa Zoro Unisex Nam Nu",45000,45000,4.5,10,27
0,0,"AO KHOAC DU BOMBER NAM NU,THIET KE HOA TIET TREN AO SIEU NGAU,CHAT LIEU VAI DU BEN BI VA THOANG MAT THOI TRANG KING STOR",89000,89000,4.5,2,2
0,0,Ao Khoac Da Bomber Nam,590000,590000,0,0,3
30000,8,Combo 3 Chiec Quan Lot Nam Boxer Cao Cap Aristino ABX 16 15,360000,330000,4.7,38,171
0,0,"Ao Thun Nam_ Nu  Phan Quang In hinh LUFFY NGHIENG , ao chat, di dem, di phuot bao ngau, nhin da mat",60000,60000,4.6,38,76
0,0,Ao thun nam unisex phong rong hoa tiet sieu hot (UX-05-42),49000,49000,4.7,15,31
0,0,Ao khoac bomber varsity jacket upset City Cycle - Ao khoac bong chay unisex form rong Local Brand,449000,449000,5,2,3
0,0,"Quan thun jogger logo in khong bong troc chat 2 da mem min, quan jogger hoat hinh, QUAN JOGGER QUAN THE THAO QUAN THOI TRANG NAM NU",95000,95000,5,2,5
31000,9,Combo 3 Chiec Quan Sip Dui Nam Thoi Trang Aristino ABX 16 03,330000,299000,4.6,17,80
0,0,"ao phao gile sieu am,giu nhiet cuc tot,FULL SIZE 45-85KG ",289000,289000,5,2,22
0,0,"Ao thun nam tay dai King168 , ao phong nam dai tay cao cap ATD17",0,100000,2.7,3,
69500,33,"Combo 3 Quan Lot Nam Chat Lieu Cotton Cao Cap, Quan Sip Nam Co Gian Thoang Mat, Tham Hut Mo Hoi Thuong Hieu BAW (Combo 3 quan mau ngau nhien) NT555",208500,139000,5,10,17
40000,31,QUAN SHORT KATE SPANDEX FEZZIO  100% COTTON CHINH HANG FZ-05 NEO,129000,89000,4.3,3,4
0,0,Ao Thun Nam Co Polo Phoi Mau Vien VTC,125000,125000,3.5,4,18
0,0,Ao thun nam unisex phong rong hoa tiet sieu hot,139000,139000,4.5,6,7
0,0,"SET BO THU DONG DAI 2021 , SIEU CHAT CHO CAC BAN TRE KEN BLOCK",135000,135000,4.5,2,2
61000,24,Ao thun the thao nam co be thun lanh co gian co size tren 80kg PigoFashion ATT01,250000,189000,5,11,42
0,0,"Do bo nam ba lo GINE EBMIN chat vai cao cap, Bo Ao Thun Cotton Sat Nach Dang Rong Phong Cach Hip-hop Cho Nam, Set Do Bo The Thao Unisex Nam Nu Vai Thun Lanh, DO BO NAM AO THUN BA LO QUAN DUI, NGUYEN BO DU SAC MAU, CHAT THUN LANH MAT, BO QUAN AO THE THAO 3 LO CHAT COTON MEM MIN MAC MAT, BO QUAN AO THE THAO SAT NACH NAM NU CHAT THUN LANH",95000,95000,4.1,10,33
0,0,Bo 5 Chiec Quan Dui Nam Mac Nha Phoi Soc,68000,68000,3.6,72,778
0,0,Quan short lung thun nam Novelty 1811710,149000,149000,5,2,8
180000,42,"Ao So Mi Nam Ngan Tay 5S (2 Mau), Hoa Tiet Nhi, Chat Lieu Bamboo Thoang Mat, Chong Nhan, Khang Khuan (SMC21013)",429000,249000,5,20,35
0,0,"Ao so mi nam trang dai tay cong so cao cap chat lua Hamino form slimfit om dang thoi trang Han Quoc mau trang den hang VNXK, ao so mi nam dai tay cong so Han quoc cao cap den trang",99000,99000,0,0,7
0,0,Ao Khoac Nam Cho Mua Lanh,218000,218000,5,2,2
0,0,AO KHOAC DU NAM NU BOMBER PHONG CACH BONG CHAY THOI TRANG,71000,71000,3.7,3,7
0,0,Quan short dui nam phoi mau phong cach Han Quoc sq502,129000,129000,4.3,68,411
0,0,Ao kaki nam nu nhieu mau phong cach han quoc phu hop voi moi lua tuoi,99000,99000,4.5,8,17
71000,42,"Ao So Mi Nam KOJIBA Dai Tay Cong So, Kieu Dang Tre Trung, Hien Dai (Nhieu Mau)",170000,99000,3.9,245,3398
0,0,"Ao Thun Phan Quang 7 mau  co khac chu ""MUA C O V I D CACH XA 2 MET"" phong rong hoa tiet, trang den nhin bao chat, thich hop len do di bar, karaoke, va phuot",59000,59000,4.2,21,60
0,0,Quan Jean nam kieu dang Slim fit Chat Jean cao cap xuat khau Mau Xam - Mau Xanh nhat,0,550000,3.4,8,
0,0,Bo Quan Ao Nam Ao Ni Quan Jogger Bo Gau Phong Cach The Thao Thoi Trang Zenkonu TOP NAM 1000123 + QUAN NAM 1000069,109000,109000,3,3,8
0,0,Ao Khoac KaKi Gio Du Nam Han Quoc Trai Dat (unisex nam nu deu mac duoc),134000,134000,4,9,19
0,0,Quan lot nam cao cap Lavic LV4113,50000,50000,5,2,38
35000,50,"Quan sip nam boxer onesize chat thun cotton tham hut mo hoi, de dang van dong - FORMEN SHOP - FMQS016",70000,35000,5,3,7
0,0,Quan Jean Nam Dep️️ Quan Bo Nam Mau Moi Chat Lieu Denim Cao Cap Thoi Trang Chuan Hang Shop To To Shop - QJN65,169000,169000,5,1,2
0,0,"ao nam dai tay thu dong co tron,4 mau nam tinh,full size den 85kg - Ma SP3",162000,162000,3.3,4,10
0,0,"Ao khoac du nam nu unisex kieu somi form rong, 2 lop day dan (Lestreet) ",99000,99000,4.2,5,10
0,0,"Quan dui nam danh bay cai nong mua he,du size 35kg-95kg T36",139000,139000,5,7,19
0,0,Ao thun nam co co ngan tay hang chuan chat vai 100% cotton mem min mac thoai mai mat me,79000,79000,4.5,39,105
0,0,Ao Khoac Long Cuu 3 Lop Loai 1 Hang Tot Nhat Cho Nam Nu- Sieu Day & Giu Nhiet,715000,715000,4.6,7,16
111000,37,Quan short kaki nam tui hop thoi trang cao cap HAHAMAN KKTH0402,300000,189000,4.5,12,30
127000,47,Ao Khoac Nam Ao Khoac Du Nam 2 Lop Cao Cap-AD27,270000,143000,4.5,229,1021
90000,36,Ao khoac du day nam 2 lop chong nang gio lanh cao cap ShopN6 - KAD46 (Nhieu Mau),249000,159000,4.2,85,309
0,0,Ao Thun Coc Tay Nam co Tron D4321T1555 GENVIET,258000,258000,5,2,4
0,0,Ao dui nam co be ao so mi nam coc tay vai dui cao cap co tui hop thoang mat mac mua he Micado,99000,99000,3.2,5,12
0,0,"Ao khoac da nam , ao da nam , ao khoac nam chat da co khoa keo nguc",199000,199000,3.7,6,11
0,0,quan dai joger mau xanh,49000,49000,0,0,1
71000,42,"Quan Dui Nam Guzado GSR01 Phong Cach The Thao Khoe Khoan, Chat Gio Mat, Co Gian Tot, Van Dong Thoai Mai ",170000,99000,4.7,23,82
0,0,hop 4 chiec quan lot dui nam boxer 100% cotton co dan sieu dep,88000,88000,2.7,10,35
0,0,Ao khoac da nam ao khoac nam co khoa keo nguc hinh that,185000,185000,4.5,20,42
172000,46,Combo 02 Quan Lot Nam Jockey Trunk Thun Cotton Pima - JUMB0315,370000,198000,5,2,6
173000,51,Bo Mac Nha The  Thao Nam Mua He Thun Mong Cao Cap ZERO - BTT19 XAM - L,338000,165000,5,6,13
0,0,"Do Bo nam the thao in chu TGTW, Do Bo Nam, quan ao the thao nam, do bo the thao mac nha nam, BO QUAN AO THE THAO MAC NHA, THOI TRANG NAM NU, BO DO NAM / BO DO NU / BO QUAN AO NAM /BO QUAN AO THE THAO BO DO NAM NU",90000,90000,4.8,4,17
0,0,"Ao Hoodie Hoa Tiet Con Bo Sua Cap Nam Nu Chat Ni PE Cotton Cao Cap, Ao khoac Hoodie Zip Ni Bong Bo Sua unisex nam nu deu mac duoc Co Clip Can Chat,  Ao hoodie nam / ao hooodie nu /Ao Hoodie/ Ao Khoac Ni Bong Bo Sua Form Rong Unisex Nam Nu HOT TREND 2021",95000,95000,3.5,2,5
0,0,Bo quan ao the thao nam,51000,51000,4.5,5,12
100000,30,"Ao So Mi Nam Ngan Tay (4SMCB002TRK) Trang Tron,Chat Vai  Cotton Cao Cap Thoang Mat Phom  Bodyfit  Tre Trung,Thanh Lich, ,Mem Min Hang Chinh Hang BILUXURY",329000,229000,5,4,9
0,0,"sip nam tam giac cotton thun lanh co dan 4 chieu,combo 4 quan 4 mau cao cap",115000,115000,5,4,46
104000,47,"AO GIU NHIET NAM, CHAT THUN CO GIAN 4 CHIEU",220000,116000,5,6,24
0,0,Ao thun dai tay nam nu,75000,75000,4.6,20,52
30000,9,Ao Blazer Caro 2 Lop Nam Nu Form Dang Rong Phong Cach Han Quoc BZ15,349000,319000,4.6,7,16
0,0,Ao thun Teeworld Saigon - Everything you need to know Form Rong Unisex Nam Nu,329000,329000,4.6,5,11
0,0,Ao thun tay lo HADES - EMOJI,420000,420000,5,2,7
0,0,Ao Thun Co Co Mau Tron The Basic Vai Ca Sau Co Gian 4 Chieu,109000,109000,5,34,84
0,0,"Quan lot nam tam giac chat lieu mong nhe, co gian thoai mai chinh hang Santino",95000,95000,4.8,13,35
209000,50,Bo Ni Nam Kieu Dang The Thao Vai Da Ca Cao Cap Thoi Trang VICERO,418000,209000,4.3,119,437
50000,25,Quan dui nam mac nha iBasic PANM088,199000,149000,4.5,6,25
0,0,quan jean nam big size 90kg co gian hang dep form xuat khau,115000,115000,4,14,52
101000,40,Ao thun nam co be dai tay Kojiba chat cotton co dan nhe dang om cong so,250000,149000,4.5,56,149
0,0,Quan ngu nam co mieng lot nang do - vai lo thoang mat - quan lot 2in1 cao cap - quan ngu nam co lot trong,88900,88900,4.3,26,121
96000,30,Ao thun tay lo GENZ Premium Cotton phong nam nu oversize unisex form rong Pharaon - GTZ072,315000,219000,4.7,3,6
0,0,"Ao khoac bomber nhung ,Ao nhung , ao khoac nhung nam . ao khoac nhung nu , ao khoac bomber cap doi  , ao khoac cap doi , ao bomber vai nhung day min",147000,147000,3.5,2,2
216000,44,"Ao thun nam ngan tay co co ARISTINO, ao poloman chat lieu PE ben mau, co gian thoai mai, thiet ke tre trung nang dong - APS010S1",495000,279000,5,3,4
0,0,"Ao Gio 2 Mat Pmax, 2 Lop, Mac Cho Ca Nam Nu, Chong Nuoc, Chong Gio, Chong Nang, Phom Tre Trung",239000,239000,4.8,20,36
0,0,Quan Sot Jean Nam,79000,79000,0,0,
0,0,Quan jean nam cao cap LE511 nhap khau dang Han Quoc cuc chuan - Mau xanh truyen thong,155000,155000,3.3,3,8
0,0,"Sip nam, quan lot nam thoang khi chat lieu Cotton hoa tiet Ran ri nguy trang",35000,35000,5,13,35
258300,41,Quan jogger the thao nam kaki Kieu tui hop Cao Cap dang bo ong Han Quoc chat vai dep ong dai,630000,371700,5,2,4
156000,55,"Ao Thun Nam Ngan Tay Co Tim (5APKH001XDU) Chat Lieu Cotton Cao Cap ,Tre Trung Thoang Mat Chinh Hang Biman By BiLuxury",285000,129000,4.8,5,8
41000,27,Quan Short Dui Tron unisex N7 the thao basic nam nu oversize phong cach duong pho Han Quoc ,150000,109000,3.5,2,4
127200,44,"Quan Jean Nam Den phoi rach thuong hieu Julido Store, mau moi phong cach han quoc 2021 TY00001",286200,159000,4.5,38,79
0,0,Quan Jean Baggy nam xanh sang nhat ong xuong rong TR03 style han quoc 2021,167000,167000,0,0,4
30000,13,Combo 3 quan lot nam Brief Modal (go soi) mem mai thuong hieu Coolmate,229000,199000,4.3,6,27
169000,42,Ao Hoodie Nam Biman By Biluxury (4ANOT008GHT) Chat Ni Day Co Mu Kieu Dang The Thao Tre Trung Mem Min Khong Bong Xu,398000,229000,4.8,8,14
0,0,"(Hang Cao Cap) Ao Gio Pmax, 1 Lop, Vai Xin co dan, Mac Cho Ca Nam Nu, Chong Nuoc, Chong Gio, Chong Nang, Phom Tre Trung",239000,239000,4.6,13,16
0,0,"Do bo PIJAMA NAM dai tay hoa tiet Caro nam tinh, chat Cotton 100% thong thoang mua he, style Han Quoc thoi thuong",450000,450000,4.7,3,14
76000,50,"Do bo nam he y hinh, vai em, mat, khong ra mau, khong do long (pika..)",152000,76000,4.5,6,26
0,0,Quan Boi Di Bien  Nam Day Rut The Thao Cleacco Deenyt  - Hang Chinh Hang,199000,199000,4.8,12,73
59000,50,"Ao thun nam tay dai mac thu dong giu nhiet chat cotton, ao giu nhiet nam co gian, 5 mau lua chon, size ao tu 40-80kg, khong bi bai xu khi giat may",118000,59000,3.1,14,82
0,0,Ao ba lo co vuong nam phong cach Han Quoc SA455,32000,32000,2.3,3,26
236000,66,"Ao Thun Tshirt Nam Hoa Tiet (APKH063GHS) Chat Lieu PE Cool Cao Cap Tre Trung,The Thao, Thoang Mat Chinh Hang BILUXURY",355000,119000,4.3,6,19
144000,44,"Quan Bo Nam cao cap thuong hieu Chandi, chat jean co dan mau moi 2021 MA86",324000,180000,4.6,7,13
0,0,AO KHOAC JEAN NAM,148000,148000,4.3,4,15
42000,20,Quan Lot Nam Jockey Tam Giac Khong Duong May Seam Free Mau Trang Khang Khuan Cao Cap - JMMB9133-11,210000,168000,5,4,11
0,0,Ao Thun Teelab Grey Trame TS049,199000,199000,5,1,9
0,0,Ao so mi dui ngan tay co be cao cap,75000,75000,3.5,14,33
0,0,"Ao thun Nam Nu Vonesa, ao phong Unisex Nam Nu co Size be tu 25-84kg A3",40000,40000,5,2,3
0,0,"Ao chong nang KHOA KEO CAO CHE MAT CHO NAM vai thong hoi thoang mat, DAI TO",62000,62000,4.5,2,11
171000,36,Ao Khoac Du Nam Cao Cap 2 Lop AKUBA | 01I505,469000,298000,5,2,8
0,0,"quan short nam , quan dui namchat dui lua sieu mem mat",99000,99000,4.8,15,23
138000,60,"Ao polo nam tui gia GUMAC du mau thanh lich, tre trung ATNB481",230000,92000,5,26,59
90000,31,Ao phong nam ngan tay cao cap dep co tron chat vai cotton co gian 4 chieu thoang mat ZAVAS  Z14,289000,199000,5,7,20
120000,25,"Quan tay nam Amazing mau den va xanh den, size 28 den 40, form cong so truyen thong, khong ly, ong suong",489000,369000,4.3,45,121
0,0,Ao so mi nam tay dai trang cong so vai oxford cao cap ND02,209000,209000,4.6,51,105
0,0,quan short tay nam vai au ,99000,99000,4.2,36,91
59000,50,Ao phong unisex form rong nu nam thun unisex co tron cotton oversize gia re in hinh Henri Martis ,118000,59000,3.6,5,7
69000,50,Quan dui nam thoi trang nu thun cotton da ca unisex the thao MR.MIB cao cap ong rong bigsize mac nha ngu han quoc dep,138000,69000,4.3,3,5
0,0,Ao khoac jean nam from rong va rach JB15,129000,129000,4.1,13,36
0,0,Ao dui nam vai mat,59000,59000,4.2,83,225
0,0,"Ao Khoac Dien Suoi Am Giu Nhiet -   Ao Khoac Suoi Am Bang Dien Sac USB Sieu Nhe, Ao Khoac Phao Mu Ao Co The Thao Roi",660000,660000,3,8,17
0,0,Quan Baggy Nam Nu Kaki Ong Suong Unisex,85000,85000,3.4,8,29
0,0,Ao thun nam tay lo form rong Unisex Methata Freesize mac vua tu 45 - 70kg ,39000,39000,4.5,16,41
150000,50,Ao Ni Nam 8 Mau Tre Trung Nang Dong Thoi Trang Cao Cap VICERO,300000,150000,4.8,9,20
59000,50,Ao phong nam nu unisex tay lo thun form rong teen co tron oversize cotton gia re basic den trang tee pull freesize PREFTED ,118000,59000,4.8,6,16
0,0,Quan Au Nam Dang Om DEN99 (Den),159000,159000,5,1,1
0,0,Ao thun BASIC,79000,79000,4.7,3,4
0,0,Ao Hoodie Teelab Premium Pullover HD038,350000,350000,3.7,3,13
159200,44,Ao Thun Polo Nam Co Be Tay Ngan Phoi 3 Mau Chu Dao Thoi Trang Men Luxury PL3,358200,199000,5,5,18
10000,7,"Quan Jogger Nam, Quan dai the thao nam chat thun dep co gian tot",139000,129000,4.6,9,42
216000,44,"Ao thun nam ngan tay co co ARISTINO, ao poloman chat lieu Cotton in hinh phoi vai tao diem nhan an tuong - APS008W1",495000,279000,5,8,9
228000,44,Ao Polo Nam Tron Cao Cap AKUBA | 01J645,515000,287000,4.7,13,38
0,0,"(Video Anh That ) Ao hoodie THIS'S FACLY ao khoac ni form rong Unisex Nam Nu Couple deu duoc, Ao Hoodie tay phong chat ni bong cuc min chu nhat - Form rong Unisex Nam Nu Couple deu mac duoc",70000,70000,5,1,2
0,0,"[SIEU NHE - SIEU AM] - Ao Tabalo Retro Nuptse Jacket, Ao Phao Beo Chong Nuoc, Can Gio Cuc Tot",650000,650000,5,4,10
51000,34,"Ao Thun Nam Co Be KOJIBA 4 Chieu Cao Cap, Tre Trung (Nhieu Mau)",150000,99000,3.8,251,3052
159000,50,Ao polo nam ADINO mau be vai cotton co gian thiet ke basic tre trung PL44,318000,159000,5,2,4
102000,23,Ao Thun Nam Co Co Polo Tron AKUBA Cao Cap | 02D109,449000,347000,5,7,16
0,0,Ao khoac da nam lot long SITAKI cao cap - AD14 Den,299000,299000,3.5,2,2
111200,44,Ao khoac nam chat kaki 2 lop xin xo Julido Store mau moi theo xu huong thoi trang Trend001,250200,139000,3.6,7,24
0,0,"Ao So Mi Nam Gold Flo Tay Ngan FEAER DENIM Form Suong, Chat Lua Cao Cap, Hoa Tiet Tre Trung ",349000,349000,4.7,13,21
0,0, Quan sip nam Aristino soi bamboo ABX03807,110000,110000,4.3,3,14
0,0,Ao so mi nam coc tay May 10 ma 010121174OLLT 456 ,156000,156000,4.5,10,21
0,0,Quan lung Nam kaki Hang chat luong cao,45000,45000,2.3,7,30
0,0,Quan lot nam thun lanh nhat ban quan lot nam khong duong may sip dui lua sua QMEN alida2010,36000,36000,0,0,
0,0,Quan Dui Nam Cotton Dang Ngo The Thao - Quan Short Nam Ke Soc 2 Ben Basic Chat Cotton Mem Mai Co Day Rut Chac Chan,75000,75000,5,9,14
144000,44,"Quan Short Jean Nam co dan kieu dang tre trung don gian Thuong Hieu Chandi, quan sot mau moi xu huong 2021 QSJN256",324000,180000,4.6,12,21
0,0,"ao thun hoa tiet loai xin thoi trang cao cap nam King168 , ao phong tay dai nam P12",129000,129000,4.5,4,5
0,0,Quan jean nam ong dung wash rau meo SJM-590-17,590000,590000,4.5,2,3
55000,46,"AO THE THAO NAM,TAP GYM HAHAMAN THUN LANH CAO CAP TT0105",120000,65000,4.5,11,26
0,0,AO SO MI NAM QUANG CHAU LUA KATE CAO CAP IN HOA TIET ROMA ANH KIM SANG TRONG,135000,135000,3.8,171,1180
0,0,Bo ao khoac the thao thu dong cao cap thuong hieu SITAKI,505700,505700,1.5,2,4
0,0,AO KHOAC DA NAM LOT DU 6 DAY KEO ,622700,622700,5,5,6
0,0,Ao thun Voga co tron co tay vai cao cap go soi Modal,149000,149000,5,20,139
195000,43,Ao khoac da lot long nam thoi trang cao cap BT77,450000,255000,4.5,11,20
0,0,Ao Khoac Kaki Nam Hai Lop Phoi Moc Khoa Tui Cao Cap MK27 ShopN6,285000,285000,3.6,14,144
0,0,Quan tay nam viet tien co ly mau oliu soc gan ,540000,540000,3.5,2,2
325000,50,"Ao Phao Long Vu Nam GUZADO 2 lop Sieu Nhe, Chong Nuoc,Giu Am Cuc Tot APGZ01",650000,325000,3.3,13,28
0,0,"Quan sot nam phom dang om vai co dan nhieu mau va nhieu size, chat vai day min dep chuan shop",99000,99000,4.6,10,36
0,0,Ao Khoac Jean Nam Rach dep Y Hinh,165000,165000,4.5,19,71
127200,44,"Quan jean nam chat jean xin Julido, Phoi rach mau moi form dep ton dang khong qua om mau Top07",286200,159000,4.3,40,107
0,0,"COMBO 4 QUAN LOT BOXER NAM cao cap chat vai mem min, thoang mat hut mo hoi tot kieu dang quyen ru L2892",99000,99000,4.1,19,83
0,0,Ao so mi nam coc tay May 10 ma 010119069 AH197,288000,288000,4.8,4,7
0,0,"Combo 2 Ao thun nam thoat nhiet Nhat Ban GOKING sieu thoang mat, ao phong nam hang hieu cao cap xuat khau",288000,288000,4.5,43,178
91000,26,Ao so mi nam tay dai ADINO mau xanh than vai soi soi modal dang slimfit tre trung S305,350000,259000,5,2,3
195000,57,Combo 2 Quan shorts the thao nam dang sot sport dui chat thun lanh 4 chieu cao cap phu hop tap gym hay mac nha mau trang va den DUI-P101 (tang 1 vi),344000,149000,4.6,23,60
34000,43,Ao Thun Nam In Hinh Paris Everest AokNAM418 (Trang),79000,45000,4.5,51,799
79200,44,"Ao thun nam co be tay ngan tre trung, chat lieu cotton cao cap mau THUU63",178200,99000,4.5,17,33
111200,44,Ao khoac nam chat kaki 2 lop xin xo Julido Store mau moi theo xu huong thoi trang Trend QA04,250200,139000,4.3,12,50
0,0,Ao Thun Nam Lon Tuoi Co Tui Trung Nien ( chat lieu 100% cotton mem min),159000,159000,4,4,8
0,0, khoac nam mua dong ao khoac phao co mu trum dau,535000,535000,3.5,2,5
44100,37,QUAN NGU NAM FEZZIO THUN COTTON 4 CHIEU ,119000,74900,5,12,36
0,0,Quan dui nam mac nha!!!!,100000,100000,3.8,4,28
0,0,"Ao So Mi Nam Cowboy Tay Ngan FEAER DENIM Form Suong, Chat Lua Cao Cap, Hoa Tiet Tre Trung ",280000,280000,4.6,20,52
0,0,Ao thun nam unisex phong rong hoa tiet sieu hot (UX-06-29),59000,59000,4.2,17,40
99000,50,AO THUN NAM DAI TAY,198000,99000,3.2,11,30
49000,50,Ao Thun Nam Tay Dai D403,98000,49000,5,2,5
36200,25,Ao khoac du nam co dung hai mat cao cap AKD2000,143200,107000,4.8,4,14
0,0,Ao thun unisex hoa tiet hot trend japan hat,29900,29900,4.5,41,121
0,0,Quan Short Nam Rach️️ Quan Short Bo Nam Cao Cap - Sot Jean Co Gian Mau Moi Hang VNXK To To Shop -QSJN06-Ma 216,149000,149000,5,1,2
108000,44,"Ao khoac nam JJ07 , khoac du 3D nam 2 lop phoi non khong thao roi thoi trang han quoc tre trung cuon hut Julido mau THU37 chat lieu tham hut mo hoi day dan mac thoang mat",243000,135000,4.1,87,269
155000,41,"Ao khoac nam cao cap Galvin London, vai Xi Nhat day dan khong nhan, ben trong co lop cach nhiet giu am, chong nang, chong gio bui tot    ",380000,225000,4.8,6,16
0,0,"Ao thun tron nam nu chat thun mem min, cotton 4 chieu tham mo hoi tot du size( co big size)",39000,39000,4.8,9,68
0,0,Bo quan ao the thao nam nu in co,85000,85000,4.5,2,2
0,0,Quan Pant Kaki - Jogger Tui Hop Han Quoc ,97000,97000,0,0,
0,0,"Quan kaki nam dai ong suong, nhieu mau, size tu 43kg den 80kg deu co - NH Shop",159000,159000,3.1,9,28
0,0,"Quan dui nam, quan dui dai nam cap chun",156000,156000,4.5,2,9
127200,44,"Quan jeans nam co dan , quan bo nam kieu tron xuoc dang vua khong bo sat thiet ke tre trung don dieu pha cach gom 5 kich thuoc (28-32) Julido mau QJNM08 - Mau xanh dam",286200,159000,4.5,36,86
127200,44,"Quan short nam trang tron chat bo co dan Julido, dang dung form dep mau moi KK04",286200,159000,4.7,23,52
81000,41,Ao so mi nam caro cao cap ngan tay Hahaman HM17,200000,119000,3.7,3,7
0,0,"Ao so mi nam dai tay cong so dang om so mi nam trang co be vai lua thai chong nhan chong xu, chat vai day dan co gian nhe, size tu 45-80kg, giat duoc may giat",99000,99000,4.2,17,62
0,0,"Quan au nam Vai ke chong nhan, Quan tay nam vai ke sanh dieu",104000,104000,4.5,2,3
21000,6,"Combo 3 Chiec Quan Lot Nam Tam Giac Cao Cap, Quan Lot Nam Det Lien, Co Dan 4 Chieu Kwin KBF1711 - Hang Chinh Hang(Giao Mau Ngau Nhien)",330000,309000,5,9,40
111200,44,Ao khoac nam JJ12 kaki 2 lop phoi non khong thao roi thoi trang han quoc tre trung cuon hut Julido mau TT05 chat lieu tham hut mo hoi day dan mac thoang mat,250200,139000,4.2,97,205
0,0,QUAN JEAN NHUNG NAM WASH NHE PHONG CACH SANG TRONG,200000,200000,5,3,
0,0,"Ao Khoac Hoodie Nam Thu Dong Phoi 2 mau, In Hinh Phong Cach Co Mu Trum Dau Hot Trend 2020",129000,129000,4.5,140,302
159200,44,"Quan Jean Nam cao cap co dan 4 chieu Thuong Hieu Chandi, phong cach han quoc tre trung ca tinh HD23",358200,199000,4.7,42,100
50000,42,QUAN NGU NAM THUN 100 % COTTON FEZZIO,119000,69000,5,8,29
0,0,"	AO KHOAC NHE NAM ""DXPECHER"" IN HINH HOA TIET",159000,159000,4.2,416,5799
0,0,"Quan short nam lung phoi thun,chat kaki thun",55000,55000,3.4,21,75
80000,62,Quan Short The Thao Nam Hahaman Co Gian Cao Cap HAHAQS01,129000,49000,4.5,16,57
131000,47,"Quan jogger nam tui hop phong cach duong pho, chat gio du cao cap mem min E02",280000,149000,4.3,6,13
0,0,AO KHOAC NAM QUANG CHAU LOT LONG CHO MUA DONG AM AP- lot long toan bo ao,199000,199000,3.4,162,472
0,0,"Set 4 Quan Lot Nam 5S (5BX020-01) Chat Lieu Cotton Cao Cap, Mem Min Thoang Mat",300000,300000,4.6,87,215
0,0,"so mi nam - kieu dang Han Quoc, sieu sang (D2)",148000,148000,5,6,17
0,0, Ao thun tay lo form rong theu chu BACKHANDER - Unisex nam nu deu mac duoc,49000,49000,3,2,6
0,0,quan the thao nam jogger thu dong big size cho nguoi beo nguoi map,399000,399000,4.7,6,9
0,0,Quan Jean Giay QD-089,395000,395000,4.5,59,168
0,0,Bo 3 ao thun body ba lo nam Taki Taki,150000,150000,4.3,185,486
0,0,"Quan JOGGER Kaki Nam Nu Ran Ri du 6 Mau Kieu Bo Ong Han Quoc - Chat lieu vai day dan, mac cuc thoai mai 004 -Minhstore88",39000,39000,0,0,
78000,46,"[LOAI DEP] Ao gio nhe nam nu 2 lop co tui dung chong gio, chong nuoc, chong bui, chong nang ",170000,92000,4,25,74
140000,43,"Quan jogger nam tui hop K94 chat kaki mem min, phong cach duong pho",325000,185000,4.3,15,22
0,0,Ao Thun Nam Ba Lo Sat Nach Tank-Top Thun Det Kim Co Dan 4 Chieu Thoang Khi Cao Cap Khong Vien Big Sport,105000,105000,4.7,62,207
0,0,"Ao thun nam tay dai King168 , ao phong nam dai tay cao cap ATD15",0,100000,3.8,4,
0,0,AO LOT NAM TRANG TAY NGAN LOAI TOT- co hinh that,29000,29000,4.3,3,14
90000,41,"Quan Suong Ong Rong Nam Vai Cao Cap E'mer , Quan Den Ong Suong Unisex Form Rong Phong Cach Han Quoc",219000,129000,4.5,5,10
78500,50,SET DO BO THUN LANH NAM VAI CO GIAN TOT (USA),157000,78500,2.9,10,26
0,0,Bo Quan Ao Nam Ao Ni Nam Co Tron Dai Tay Quan Jogger Nam Bo Gau Thoi Trang Zenko TOP NAM 1000113 + QUAN NAM 1000069,109000,109000,4.8,4,10
0,0,Ao khoac da nam day keo dong da xin KHONG BONG TROC hang xin cao cap nhat 2021 ,195000,195000,0,0,1
0,0,Quan kaki baggy nam nu cuc chat,71000,71000,4.2,12,62
0,0,Ao khoac jean nam from rong va rach AKJN04 (Xanh bo),129000,129000,4.5,18,50
229500,50, Ao so mi nam Novelty ngan tay 171427N vat bau ,459000,229500,4.3,3,6
0,0,"[HANG XIN ] Quan au nam, quan tay nam chat vai cheo cao cap  , kieu dang sang trong ,sang trong QN01",250000,250000,5,15,47
0,0,Ao so mi nam mau trang dai tay vai chong nhan  - Trang  - L,85000,85000,0,0,
0,0,Ao so mi nam ngan tay trung nien vai dui SIEU MAT form rong rai thoai mai loai ao so mi nam nguoi gia caro OG58,99000,99000,3.5,11,37
279000,52,Ao Khoac Nam Vai Gio 2 Lop Thoi Trang Vicero,538000,259000,5,4,7
186000,38,"Ao So Mi Nam Ngan Tay (4SMCH004XNH) Hoa Tiet Caro Chim, Phom Bodyfit  Tre Trung,Thanh Lich, Vai  Polyspun Cao Cap Thoang Mat,Mem Min Hang Chinh Hang BILUXURY",495000,309000,4.8,4,6
0,0,"Quan Short Nam ROUGH Chat Nhung Tam Dang Short Ngan Ulzzang Han Quoc Tre Trung, Ca Tinh",130000,130000,4.7,13,17
70000,27,"Combo 3 Quan Sip dui Nam, Quan Lot Nam Boxer Cap Nho CM, Soi Cotton Mem Min, Sieu Thoang Mat, Co Gian Thoai Mai/ Tang 1 Doi Tat Cao Cap",255000,185000,4.5,26,57
56000,50, (VIDEO ANH THAT ) Ao khoac ni Alan Walker nam nu tre em va nguoi lon,112000,56000,0,0,
129000,50,Quan Dui Nam The Thao Form Dang Nang Dong Thoi Trang VICERO,258000,129000,4.6,5,30
46000,20,"Set 3 Quan Sip Nam Quan Lot Nam Soi Cotton Cap Nho Mem Min Thoang Mat, Co Gian 4 Chieu Thuong Hieu MRM FASHION",225000,179000,5,10,31
173000,51,Bo Mac Nha The  Thao Nam Mua He Thun Mong Cao Cap ZERO - BTT18 XANH THAN - XL,338000,165000,0,0,15
0,0,Blentino Quan short kaki the theo nam BSF-03(2),309000,309000,4,5,9
66000,27,Ao Khoac Big Size Unisex Ao Khoac Kaki Nam Nu Chong Lanh Chong Nang Chong Nong Chong Gio Co Tui Co Co Be Han Quoc Thoi Trang Cao Cap QK48 ,245000,179000,4.3,3,5
0,0,"ao thun nam nu form rong chat lieu co tron cao cap size 50-70kg, ao thun unisex soc ngang",49000,49000,3.8,8,20
0,0,Ao thun unisex form rong tay lo - thoi trang nam nu hot trend,60000,60000,0,0,1
0,0,BO DO NAM / BO DO NU / BO QUAN AO  NAM /BO QUAN AO THE THAO BO DO NAM NU,85000,85000,3.7,3,7
0,0,"Ao so mi co be dai tay han quoc, so mi nam trang dang om body chat lua thai tham hut mo hoi, co gian nhe, size ao tu 45-80 kg",0,99000,4.2,13,
0,0,"Quan Au, Quan Tay Nam Cong So Vai Cao Cap Phom Dang han quoc, chat vai dan chong nhan, quan baggy nam",110000,110000,0,0,1
0,0,(co video)AO KHOAC BOMBER NAM NU VAI MERO CAO CAP PHONG CACH BONG CHAY THOI TRANG LOGO THEU NGAU HOT TRIEND MOI NHAT 2021,149000,149000,4.5,56,107
111200,44,Ao khoac nam chat kaki 2 lop xin xo Julido Store mau moi theo xu huong thoi trang Trend MQ05,250200,139000,4.5,42,107
0,0,Ao thun nam trung nien ngan tay co co vai det rieng cho Thai Khang TOG9,149000,149000,4.6,5,11
0,0,Ao so mi nam viet tien dai tay mau xanh nhot petrol,350000,350000,5,3,14
0,0,Ao So Mi Nam Tay Ngan,189000,189000,3.8,9,18
80000,30,Ao thun nam dai tay Cotton Compact Premium chong nhan thuong hieu Coolmate,269000,189000,5,11,20
0,0,COMBO 4 QUÀN SHIP NHẠT DÙI COTTON,135000,135000,5,1,5
51000,21,Combo 3 quàn lót nam tam giác Bamboo organic mèm mịn thoáng mát MRM Manlywear - Màu Ngãu Nhien,240000,189000,4.7,183,881
0,0,Ao Hoodie Zip Teelab Basic Keo Khoa HD036,350000,350000,4,5,10
0,0,Quan Jogger Nam Ong Bo Thoi Trang Han Quoc JOGGER04,49000,49000,0,0,1
153000,34,Quan Short Jean Nam Rach Thoi Trang AKUBA Form Skinny | 01D19134,449000,296000,1.7,6,18
66000,49,"Quan the thao nam ngan Sport vai Thun Poly 2 Da thoang mat, hut am tot, do co gian cao, ben, thich hop mac choi the thao tap gym",135000,69000,4.8,14,47
0,0,Quan the thao nam kaki TinoFun ma TT46 tho tui hop Cao Cap jogger bo ong co gian vai dep ong dai Han Quoc he thu,69000,69000,1,2,7
0,0,Quan the thao nam kaki TinoFun ma TT33 bo ong co gian dang jogger tui hop vai dep dai mua he thu,79000,79000,0,0,4
0,0,QUAN SHORT KAKI NAM CO GIAN CAO CAP LUNG THUN BT02,39000,39000,1.8,4,5
219500,50, Ao so mi nam Novelty ngan tay 170302N vat ngang ,439000,219500,5,4,6
0,0,Ao thun ba lo nam chat vai cotton 100% thoang mat co gian Everest,59000,59000,4.3,48,158
36000,27,"Quan sip dui nam, quan lot nam boxer ARISTINO hang cao cap, chat lieu chat lieu polyamide mem min, thoang mat nho lo thoang khi thong hoi tren be mat vai. ABX060 ",135000,99000,5,3,6
69000,50,"Do bo nam he y hinh, vai em, mat, khong ra mau, khong do long (fm)",138000,69000,4.1,12,30
0,0,Ao khoac da nam day keo dong da xin k bong troc cuc ngau cho anh em THOI TRANG LANO STORE,185000,185000,3,2,5
16000,17,"Quan lot nam ARISTINO dang Brief, quan sip tam giac nam chat lieu Cotton Organic mem mai, thoang mat - ABF056",95000,79000,5,7,25
150000,50,Ao Thun Nam Polo Co Co Tay Ngan Mua He Thoi Trang VICERO,300000,150000,4.5,8,20
159200,44,"Quan Bo Nam cao cap  thuong hieu Chandi, chat jean co dan Hot Trend 2021 ma MR9038",358200,199000,5,43,93
0,0,Ao giu nhiet nam dai tay cao cap dang body dep,31000,31000,5,2,19
187000,49,Ao Thun Nam Jockey Cotton Pima Ngan Tay In Chu Mau Cam - JUMT0317,385000,198000,4.6,5,9
209000,50,Bo Quan Ao Nam Soc Tay Thoi Trang Cao Cap ZERO,418000,209000,4.3,10,34
17000,9,Ao Thun T-Top Nam Jockey Chat Lieu Visco Mau Trang Thoang Mat Cao Cap - J1151,185000,168000,3,2,10
0,0,Quan jean nam rach thoi trang - chat jean day co gian tot,98000,98000,4,5,9
0,0,"Quan tay nam cao cap kieu dang co gian 4 chieu, dang om body chong nhan , chong xu tuyet doi",99000,99000,4.5,2,2
0,0, Ao big size cho nguoi beo - Ao Thun Nam Tay Ngan - Ao Phong Bigsize,68000,68000,2.6,7,35
0,0,Ao so mi dui nam cao cap tay dai mem mai phong cach lich lam,114000,114000,3.4,7,9
109000,46,Quan Short Nam The Thao Ni Bong Thoi Trang Phong Cach ZERO,238000,129000,4.5,99,286
68000,35,Ao thun Nam GUMAC ATNB826 in trai tim,195000,127000,4.5,2,7
20000,5,Ao Hoodie nam co mu trum Classic thuong hieu Coolmate,389000,369000,5,9,26
111000,44,"Quan Jogger KaKi Unisex Tre Trung Nang Dong,4 Mau Ca Tinh",250000,139000,4.1,254,1167
0,0,Ao thun nam in chu GUMAC ATNB6115,320000,320000,5,4,20
297000,50,Quan jean nam wash GUMAC QJNB6113,595000,298000,4,5,14
0,0,Ao thun Teelab Ha Noi Tra Da TS001,195000,195000,4.6,7,15
117000,41, Quan Lot Nam Jockey Tam Giac Hoa Tiet Thun Lanh Khang Khuan Xam In - J1162,285000,168000,5,3,22
0,0,Quan short jean nam don gian cao cap,89000,89000,4.5,23,77
115000,50,Ao so mi nam in hinh dua GUMAC ANB6108,230000,115000,4.8,6,21
0,0,quan dui nam mac nha vai thun mem MAT co dan cuc tot gom nhieu size,12300,12300,4.5,4,24
59000,50,Ao thun tay lo unisex nam nu phong form rong teen co tron oversize cotton gia re basic den trang tee pull freesize MOIM FINE,118000,59000,5,5,12
109000,50,Ao hoodie unisex nam nu cap doi local brand ni ngoai form rong co mu ABDL ulzzang han quoc cute zip chong nang,218000,109000,4.8,8,15
20900,19, QUAN NGU NAM THUN LANH MONG THOANG MAT QC134,110000,89100,4.5,14,83
0,0,5  Quan Sip Nam Thun Lanh 4 Chieu X-Men Underwear ,98998,98998,4.5,41,251
0,0,ao khoac phao nam mu long cao cap lop ngoai chong nuoc,299000,299000,3.6,5,8
0,0, Quan thun den ong rong nam PHong cach han quoc - vai co gian tot,49000,49000,2.4,5,12
0,0,Combo 5 Quan Lot Nam Thong Hoi Xuat Nhat Ma S02,62998,62998,4.2,31,64
143200,44,"Ao Khoac Nam, Ao Khoac Kaki Nam Nu Hai Lop Phoi Non Khong Thao Roi Chong Nang Chong Gio, Ao Khoac Nam Thu Dong Cach Nhiet, Ao Khoac Unisex Phong Cach Han Quoc Thuong Hieu Chandi Ma AKD65",322200,179000,4.5,26,53
0,0,QUAN JOGGER NI NAM 1 SOC JG02,64000,64000,4.3,9,15
36000,31,[ Co Anh That ] Ao thun unisex tay lo form rong - soc tem vuong,115000,79000,4.6,7,12
0,0,"Ao khoac du nam nu unisex kieu bomber form rong, 2 lop day dan",75000,75000,4.6,22,53
0,0,"Ao so mi nam dai tay nam co be cao cap, ao so mi trang vai lua thai co gian nhe khong nhan thoi trang cao cap, size ao tu 45-80 kg",99000,99000,4.3,15,42
0,0,"Combo 3 quan sip dui, set 3 quan lot nam ARISTiNO chat lieu Cotton Organic mem mai, thoang mat, khang khuan, khu mui cuc tot ABX056",330000,330000,5,3,15
149000,44,Ao Len 5 Mau Nang Dong Thoi Trang VICERO,338000,189000,3.8,17,49
21000,19,"Quan lot nam ARISTINO dang boxer, quan sip dui nam chat lieu cotton thoang khi, co gian 4 chieu thoai mai - ABX03707",110000,89000,5,8,28
0,0,Bo Ni The Thao Nam Chat Ni 2 Soc Doc ROUGH,199000,199000,4.5,17,52
159000,50,Ao polo nam ADINO mau vang vai cotton co gian thiet ke basic tre trung PL43,318000,159000,5,3,6
0,0,"Quan Kaki Tron Nam ROUGH Outfit Kaki Day Dan, Co Gian",195000,195000,4.2,5,16
36000,31,[ Co Anh That ] Ao thun unisex tay lo form rong - ao phong Gau Exclusive,115000,79000,4.6,5,7
270000,42,"Quan Jean Nam 5S Mau Sac Co Ban, Chat Cotton Mem Min, Co Gian Tot, Khong Bai Xu, Ben Mau, Phom Tre Trung",639000,369000,4.8,10,32
0,0,Quan ngu nam,37000,37000,4,2,10
0,0,Ao thun Sans Undertale Ink Error S07 | Ao Chat Store,0,130800,3.6,5,
0,0,Hop combo 5 sip dui boxer SQB101 MAP,219000,219000,5,11,34
0,0,AO THUN NAM DAI TAY,149000,149000,4.6,9,23
49000,50,Ao thun nam dai tay ma TT76 co tron thu dong giu am dang the thao giu nhiet dep kieu ni chat vai dep   ,98000,49000,1,1,8
0,0, Ao So Mi Nam Trang Tron Vai Lua Cao Cap,99000,99000,0,0,
154000,48,Ao Khoac Du Nam co dung mac 2 Mat Cao Cap akd2m031,319000,165000,4,22,26
15000,50,Quan Sip Dui Nam Chat Cotton Cao Cap Co Gian Thoang Mat Cap Va Mau Ngau Nhien,30000,15000,4.8,8,46
0,0, Ao coc nam - ao thun lua khong duong may nam hot hit 2021,26000,26000,4.5,10,19
0,0,Ao thun dai tay Amintino ,39000,39000,4.1,7,15
79200,44,"Ao thun nam the thao tron, co tron dep, tre trung, mac thoang mat, tham hut mo hoi tot thuong hieu CHANDI HH1",178200,99000,3.9,15,67
0,0,"Ao polo nam , co det bo len , hinh in sac net ,ao thun nam co co tay ngan thanh lich POLO-11 - Soha Clothing",210000,210000,5,1,3
0,0,Ao So Mi Nam Tay Ngan Hoa Tiet The Shirts Studio Han Quoc TD12F2328BR,69000,69000,3.8,4,25
0,0,Ao Thun Xanh Reu - Xanh Linh,39000,39000,4.6,14,47
0,0,Ao Thun Nam Co Tru Tay Ngan Hang Hieu Cao Cap NAIKYO TS2010,400000,400000,4.7,3,9
0,0,Ao Blouse Trang,198000,198000,4.1,17,120
76000,20,Combo 5 Quan Lot Boxer Nam Freeman 6520,375000,299000,4.6,27,238
0,0,Ban tay xuong - Ao thun den nam in da quang phan quang trong toi chup flash FREESIZE,129000,129000,4.5,4,13
0,0,Quan Dui Nam Slim Fit Ong Con MANGDEN01 - Dui MG Den,49000,49000,4.7,3,6
0,0,Bo Dui Nam Co Tau AMITINO (48-85kg) Soi tu nhien Mat - Mem - Nhe,89000,89000,4.5,4,6
42000,10,OWEN - Ao so mi nam trang dai tay dang SLIMFIT soi Soi - Ma AS22753D2 ,420000,378000,4.5,2,7
96000,30,Ao thun tay lo GENZ bi mat hinh in thu su may man cua ban - BIMAT,315000,219000,3.7,3,7
0,0,Ao So Mi Nam Dai Tay Dep,189000,189000,5,4,9
0,0,Ao so mi nam coc tay May 10 ma 010121174OLLT 457,156000,156000,5,4,11
111200,44,Quan short jean nam B114 co dan kieu dan tre trung don gian theu hoa tiet Julido thoi trang han quoc,250200,139000,3.9,15,37
34000,43,Ao thun nam in hinh co My,79000,45000,4.6,11,49
34000,43,Ao Thun Nam Everest AokNAM420 - Xam,79000,45000,5,4,13
0,0,Ao Thun Nam In Hinh New York City Everest AoKNAM17 (Trang),179000,179000,4.3,10,194
144000,44,"Quan Short Jean Nam co dan kieu dang tre trung don gian Thuong Hieu Chandi, quan sot mau moi xu huong 2021 NT5057",324000,180000,5,18,30
0,0,"Quan Short Jean Nam Ngan , Quan Bo Lung Nam Co Gian Sieu Chat OBOK Fashion QSN107",149000,149000,4.3,7,13
96000,50,Ao Khoat Du Nam Nu 2 Lop,192000,96000,4,4,8
30000,17,"Quan au nam ong suong den con vai chong nhan cao cap khong bai, xu QA01",179000,149000,4.5,2,3
0,0,Quan jogger nam the thao mau den vai dep de chiu,75000,75000,2.5,2,5
0,0,Quan The Thao Jogger 3 soc Nam + Nu Chat vai ni Poly co dan the thao,165000,165000,4.5,8,16
0,0,Ao thun nam ca sau tay dai day keo SITAKI ATD06,130000,130000,4.1,26,77
59000,50,Ao Thun Nam Dai Tay Tron om body nam hot 2020,118000,59000,3.7,3,12
0,0,"SET BO BA LO THE THAO NAM PHONG CACH THE THAO NANG DONG HAN QUOC CHAT THUN LANH CO GIAN 4 CHIEU THOANG MAT,THICH HOP CHO MOI HOAN CANH SINH HOAT-DO BO MAC NHA NAM THUN LANH-JINS STORE ",90000,90000,4.7,3,3
0,0,"Ao Dai Tay Nam Nu Unisex Chat Vai Thun Cotton Drug, Ao Sweater - Ao thun nam nu tay dai giu nhiet sweater den unisex freesize unisex vai ni day, giu am ap drug",77000,77000,3,2,7
0,0,"Quan jogger nam tui hop chat kaki mem min, phong cach duong pho RFE",97000,97000,0,0,1
79000,50,"Ao thun nam dai tay co tron mac thu dong, giu nhiet, chat cotton co gian,dang om body(ACTD)",158000,79000,2.5,4,26
0,0,"Ao phao nam, ao khoac phao nam kieu dang han quoc co mu thao roi",265000,265000,4.5,5,18
111200,44,"Do Bo The Thao Nam thuong hieu Chandi, Do Bo Mac Nha chat lieu thun cao cap mat me, tham hut mo hoi tot MS903",250200,139000,4.7,10,18
155000,44,"Quan jogger nam the thao chat gio lot ni mem min, day dan 9918",350000,195000,5,2,11
0,0,Quan Lot Nam Luoi Boxer Thun Lanh – Sieu Mong – Sieu Thoang Mat,39000,39000,4.7,10,54
0,0,Ao khoac jean nam tron cao cap vai jean denim khong nong hang chuan shop Phuongnamshop20 rkv8,160000,160000,4,4,7
0,0,"Ao khoac du nam nu chay soc tay sieu dep,phong cach ca tinh tu tin,vai du 2 lop chong nang giu nhiet hieu qua,Ao khoac du 1 soc ,ao khou du , ao khoac gio",110000,110000,5,3,6
0,0,"Ao khoac jean nam King168 , ao khoac bo cao cap AK19",0,250000,0,0,
0,0,"Do bo the thao nam vai thun lanh mem min, Thoi Trang Phong Cach Han - Lee’s Home (Freesize tu 45-70kg)-Nhieu kieu lua chon",117000,117000,4.2,61,120
0,0,QUAN JEAN NAM TRANG PHONG CACH HAN QUOC - 3457817,99000,99000,4.6,16,26
0,0,"Ao so mi nam tay ngan King168, co dan nhe, mac mat khong bai mau xu long mau VQ51",0,150000,4.5,2,
0,0,Ao SOMI Den TRON DAI TAY BASIC Nam Nu Unisex (1 TUI TRUOC NGUC),77000,77000,0,0,
0,0,"Quan Jogger nam Kaki loai dep, quan nam gia re QN008",86000,86000,3.9,32,61
0,0,DEP XUAT SAC Bo Do Ngu Dai Tay Chat Kate Bo Pijama Lua Dai Tay Phu Hop Ca Nam Va Nu,65000,65000,4,6,27
0,0,"ao nam thu dong dai tay chat cotton,phong cach Han Quoc full size den 95kg - SP4",168000,168000,4.6,9,23
0,0, Quan Sip Dui aristino Chinh Hang Made In Viet Nam (ABX1603),90000,90000,3.5,2,3
0,0,"Quan ngo nam chat vai kaki , co gian nhe",92000,92000,4,6,16
0,0,AO  KHOAC HOODIE HOA  TIET RONG LUA  SIEU  DEP ,140000,140000,4,230,3147
0,0,Quan short nam ma TT12 phong cach Quan dui the thao nam dang lung thun co gian tap gym ngan di choi mua he,83000,83000,4.2,13,53
69000,50,combo 3 thun 3 lo nam dep loai cotton loai 1 mem min mat hut mo hoi cuc tot,138000,69000,2.3,3,8
0,0,Ao Somi nam denim mau xanh den 2 tui nap dai tay/ ngan tay,145000,145000,4.5,5,7
0,0,AO KHOAC KAKI CARO NAM THOI TRANG CHO MUA XUAN,179000,179000,4,4,8
8000,5,Combo 2 Chiec Quan Lot Nam Aristino ABF16-15,170000,162000,4.5,8,39
0,0,Ao So Mi Nam Ngan Tay Phoi Caro ,130000,130000,4.2,13,52
0,0,Ao so mi nam coc tay MAY 10 ma 010120003 AH234,303000,303000,5,2,8
11000,5,Combo 3 Chiec Quan Lot Nam Tam Giac Thoi Trang Aristino AC 02,210000,199000,4.8,18,61
0,0,Quan Sip Nam Chu V Nang Mong Sieu Thoang K367,62000,62000,4.8,5,29
0,0,Quan Short Nam Kaki dui LD14,59000,59000,4.3,10,40
127200,44,"Quan Jean Nam trang hoa tiet phoi Rach Julido, mau thoi trang Nam moi nhat 2021 WW01",286200,159000,4.7,40,65
1040000,52,"Bo Quan Ao KaKi Linh My US ARMY U569 Kieu Dang Tui Hop Chien Thuat, Chat Lieu Kaki Cao Cap Phong Cach Linh Cuc Ngau - HANG CHINH HANG",1990000,950000,5,17,25
0,0,Ao so mi nam nua caro den hoa tiet chu EVISU,165000,165000,4.7,6,15
0,0,"Ao polo nam co tru, thun Phoi vai cao cap from chuan, thiet ke phong cach sang trong,JULIDO51",159000,159000,5,2,7
0,0,Quan short kaki nam vai dep cotton day mac mat loai quan short day keo,79000,79000,4.8,11,30
0,0,AO  KHOAC  NHE  NAM  HAI LOP  IN  HINH HOA  TIET  W112 MOI NHAT  2020 ,159000,159000,3.6,29,284
0,0,"Ao nam chat cotton tay dai, sieu mem, mat SP4",158000,158000,5,2,6
0,0,"< FREESHIP > AO KHOAC KAKI HOP NAM NU HINH THAT CO TUI TRONG HANG BAO DEP, BAO CHAT  FORM 80KG",155000,155000,4.7,3,7
0,0,Ao Khoac Da Nam Lot Long Cao Cap,290000,290000,0,0,1
0,0,COMBO 5 BAO QUAN LOT TIEN LOI TC BODY-MATE NAM 5 QUAN/BAO,250000,250000,4.5,4,17
0,0,"Sip nam tam giac cotton thun lanh co dan 4 chieu,combo 4 quan 4 mau cao cap",115000,115000,4.8,5,49
0,0,Bo the thao nam vai mem sieu mat loai bo quan ao the thao he thun lanh mac mat BTT 02,89000,89000,4.8,10,17
0,0,Ao thun nam GUMAC ATNB848 in doi nui ,265000,265000,4.7,3,7
117000,48,Quan Lot Nam Jockey Dang Knit Boxer Thun Cotton Pima - JUMB0316,245000,128000,4.6,9,29
0,0,Ao Khoac Du Cap doi Form Rong Unisex Nam Nu HOT RE DEP Ao Gio Mau Den - Chat Du Mero Khoac Chong Nang Cuc Tot Jacket,83000,83000,0,0,3
0,0,"AO HOODIE NAM , AO KHOAC AO HOODIE CO DAY KEO TRUOC NGUC THOI TRANG NAM NU",59000,59000,0,0,1
60000,29,Ao Khoac Big Size Nam Nu Ao Khoac Du Nam Nu Co Non Chong Nang Chong Nong Chong Lanh Chong Gio Chong Tia UV Lot Luoi Cao Cap AD68 - ShopN6,205000,145000,4.7,3,10
0,0,"Ao khoac so mi nam nu mac , ao khoac so mi quoc dan hoa cuc chat kaki day min , form rong",101000,101000,0,0,
0,0,Quan Au Nam Thoi Trang Cong So BLENTINO DD19018-18-1 Co Gian Da Chieu Thoai Mai Khi Dung Ngoi,495000,495000,3.9,15,44
0,0,"Quan lot nam thun lanh khong duong may, sip dui nam cao cap kieu dang boxer nam om sat, chat lieu su thoang mat, mem min va mong nhe, quan lot cap nho don gian voi mau tron QLW806",125000,125000,5,12,32
95000,26,Combo 4 quàn lót nam Boxer Bamboo Organic mèm mịn thoáng mát thám hút mò hoi MRM Manlywear - Màu Ngãu Nhien,360000,265000,4.6,120,352
115000,50,Ao so mi nam in hoa hinh tron GUMAC ANB6112,230000,115000,4.6,7,15
38000,28,Ao So Mi Nam Ke Caro Vai Cotton Thoi Trang Vicero,138000,100000,3.3,43,77
135000,45,Bo Mac Nha Nam Chat Thun Co Gian 4 chieu Cao Cap Thoi Trang ZERO,300000,165000,4.3,15,35
0,0,AO KHOAC KAKI NAM HAI LOP CAO CAP THOI TRANG,137000,137000,4.6,17,48
46000,19,Ao Khoac Big Size Ao Khoac Du Nam Co Non Co Tru Chong Nang Chong Nong Chong Lanh Chong Gio 2 Lop Phoi Logo Thoi Trang Nam Tinh Han Quoc Gia Tot ShopN6 - QD58 ,245000,199000,4,7,19
0,0, Ao so mi nam Novelty dai tay 180485D vat bau ,295000,295000,5,8,31
40000,11,Ao vest balze nam Linen tui bo 1 khuy LAHstore - xanh nhnh,370000,330000,4.7,3,8
0,0,"Quan jogger nam rut co khoa tui, phong cach the thao voi hoa tiet tron co big size hon 80kg",79000,79000,4.6,17,43
0,0,Quan short nam lung thun chu V phong cach nang dong de phoi do 2 mau trang den thoi trang the thao,72199,72199,4.8,4,10
144000,44,"Quan Sot Jean nam co dan 4 chieu Thuong Hieu Chandi, phong cach han quoc mau moi nhat 2021 MS1006",324000,180000,4.7,7,28
190000,48,"Quan Short Kaki Nam 5S (6 mau) Chat Lieu Cotton Cuc Mat, Tham Hut Mo Hoi, Kieu Dang Tre Trung, Nang Dong (QSK21002)",399000,209000,5,55,131
0,0,Ao Khoac Da Nam Ao Da Nam Dang Ngan Sans09 Sans Shop,0,649000,3.9,8,
0,0,Hop 4 quan sip dui thong hoi Men's cho nam,77900,77900,0,0,
91000,36,"Ao thun ngan tay nam khong co ARISTINO, ao phong nam chat lieu cotton mem mai, thoang mat, hoa tiet tre trung nang dong - ATS021S1",250000,159000,5,3,6
0,0,Ao Khoac Du Nam Tron nhieu mau LV2019,199000,199000,4,2,8
61000,41,Quan thun ngan quan dui nam cotton mac nha the thao co gian thoai mai TKQCT01 PigoFashion chon mau,150000,89000,5,6,37
159000,50,Ao polo nam ADINO mau xanh dam phoi vien chim vai cotton co gian dang slimfit tre trung nang dong AP83,318000,159000,5,7,10
115000,38,Ao khoac jean nam HAHAMAN thoi trang cao cap AKJ008,300000,185000,4.5,17,23
268000,50,OWEN - Ao so mi ngán tay Owen Regular fit chát sọi tre mau tim 90848,536000,268000,5,7,13
0,0,jean nam ong suong co gian vai mem cao cap hang dep xuat khau size 55-85kg,227200,227200,4.5,13,24
48000,18,Combo 3 quan lot nam thun lanh Boxer iBasic PANM068,267000,219000,4.5,6,25
118000,25,Combo 3 quan lot nam brief khong duong may iBasic PANM021,477000,359000,5,3,9
300000,40,Ao khoac Varsity Bomber Jacket The Bad God Bony Ruffled,750000,450000,4.5,2,3
0,0,Quan Jeans Bo Nam Ngan Short Lung Ngo,119000,119000,4.5,44,255
57400,41,"Ao thun unisex ao thun nam form rong tay lo , áo thun nam cổ tròn tay ngan ao thun unisex Phan Quang Vendor",140000,82600,5,2,2
102090,41,Ao Thun Nam Tay Lo Unisex co Tron chat lieu vai cotton mau den form rong in chu CHICAGO ngang vai phong cach doc chat TheNgaustyle,249000,146910,4.7,3,6
20000,8,Ao phong co tron Cotton Compact in chu Coolmate,259000,239000,5,5,20
111000,20,"Bo nam thu dong Narsis E9010 chat ni mau den phay  tre trung nang dong, chat lieu  cao cap cuc mem mai thong thoang",555000,444000,4.3,3,6
13000,22,Quan short nam du THE 1992 Quan dui nam vai gio basic,58000,45000,4.5,17,61
127200,44,"Quan jean nam mau xanh co hoa tiet dep hang moi ve, dan dau xu huong da co mat tai Julido Store  mau moi MA25",286200,159000,4.5,68,136
0,0,Ao Hoodie Ni Nam Co Mu Hoa Tiet Chu PDBOY Ca Tinh Thoi Trang Zenkonu TOP NAM 1000116,69000,69000,2.5,2,5
0,0,Ao Khoac Du Nam ASALA,59000,59000,4.2,25,97
51000,43,Quan dui nam THE 1992 vai dui Quan short nam LINEN,120000,69000,4.7,24,82
29370,11,COMBO 3 QUAN LOT NAM RELAX RLTK017 DANG BRIEF CHAT LIEU COTTON CO GIAN 4 CHIEU ,267000,237630,5,8,11
50000,11,Bo ni nam co chui Laroma | Giu am - Khu mui,449000,399000,4,2,3
0,0,"Combo 4 Quan lot, quan sip dui Cotton cao cap danh cho nam- Le Ngoc Fashion",115000,115000,3.7,3,11
0,0,Ao So Mi Nam Ngan Tay Hoa Tiet O Vuong Cao Cap Thoi Trang Chat Vai Khong Nhan Khong Xu,135000,135000,3.9,10,25
102000,51,Ao Thun Tay Ngan Nam Nu Dang Suong URBAN OUTFITS In Minimal ATR07 Cotton 4 Chieu,200000,98000,4.6,7,27
127200,44,"Quan Jean Nam Rach Sieu Cap thuong hieu Julido Store, Jean co dan 4 chieu mau wash chuan Mau moi nhat 2021 QJ678",286200,159000,4.8,25,31
0,0,"Ao Hoodie Tokyo Revengers, mu Tokyo Revengers, balo  Anime, cap",85000,85000,4.3,7,16
0,0,Ao giu nhiet nam ao dai tay nam ao the thao nam Amintino,39000,39000,4.6,8,73
42000,20,Quan Lot Nam Jockey Tam Giac Khong Duong May Seam Free Mau Den Khang Khuan Cao Cap - JMMB9133-11,210000,168000,5,2,9
0,0,Ao hoodie nam mau den vai ni cuc dep freesize duoi 65kg,75000,75000,4.7,3,10
116000,59,Ao tui xeo in luoi GUMAC ABA1265,195000,79000,5,20,44
195000,60,"Ao thun nam in chu GUMAC du mau, du size, phong cach nang dong tre trung ATNB1183",326000,131000,4.7,33,70
40000,29,QUAN LOT NAM BOXER VAI SOI MODAL (GO SOI),139000,99000,5,6,72
80000,24,"Quan baggy nam Amazing, chat lieu kaki, lung thun co giay rut, form om Unisex, ton dang dep, tre trung-02",339000,259000,4.3,30,82
209000,50,Bo The Thao Nam 4 Mau Tre Trung Nang Dong VICERO,418000,209000,4.1,14,43
0,0,Combo 5 bao quan lot giay du lich PP Travel - Mate Nam 5 quan/bao,150000,150000,4.7,15,108
421000,50,"Ao khoac nam 2 lop Aristino, ao khoac gio nam co mu KJK003W9 phom Regular Fit suong nhe, thoai mai voi mat vai Jacquard thoi trang va manh me.",850000,429000,5,10,17
0,0,"Ao blazer nam, Ao vest form rong phoi co tay sanh dieu Han Quoc Thoi trang nam HERO- BZ12",814100,814100,0,0,
45000,33,"Quan lot nam thun lanh khong duong may, sip nam tam giac cao cap chat lieu thoang mat, mem min QLW606",135000,90000,4.6,310,1318
5000,10,Ao thun nam ba lo van dap vai thun lanh co dan 4 chieu xin xo loai ao sat nach nam ATSN03,49000,44000,4.2,27,106
21000,19,"Quan lot nam ARISTINO dang boxer, quan sip dui nam chat lieu Modal mem mai, thoang mat gap 2 lan so voi soi vai thong thuong - ABX1616",110000,89000,5,7,35
14000,14,Quan tay nam ong suong trung nien vai day mem khong ra mau ,99000,85000,3.9,9,36
159200,44,"Quan Kaki Nam cao cap thuong hieu Chandi, chat kaki co gian xu huong 2021 ma NT300-MAU DEN",358200,199000,4.5,37,75
0,0,"Bo The Thao Nam fashion, Nang Dong Thoai Mai Mua He, Bo quan ao the thao in chu fashion cuc dep, set bo the thao nam nu Han Quoc mem min tham hut mo hoi cuc nhanh, Bo quan ao the thao chuyen gym mau moi",97000,97000,4.8,5,11
0,0,"Quan Short Nam Chat Gio Co Gian Sieu Nhe Thoang Mat,Quan Dui Nam 4 Mau Mac Nha Nang Dong",39000,39000,1.5,2,2
159000,50,Ao polo nam ADINO mau den vai cotton co gian thiet ke basic tre trung PL41,318000,159000,5,2,4
89000,50,"Ao Oversize BOBUI Do Phan Quang , Tee Bobui Saigon Reflective RED ",178000,89000,1,1,3
0,0,"Quan baggy thoi trang nam BAT cap cao, chat lieu co gian thoi trang doc dao lich lam phong cach Han Quoc.",199000,199000,5,2,5
0,0,"Ao Thu Dong Nam, Ao Thun Nam - Nu Dai Tay - Ni Nam - Chat Lieu Poly 2Da cao Cap N05",148000,148000,3.7,3,
0,0,"Quan Tay Nam Cong So FAJA Tre Trung, Chat Lieu Cao Cap (Mau den)",95000,95000,4.3,34,198
0,0,"Quan Lot Nam Khong Duong May Mong Nhe Thoang Mat Chong Han Hoa Tiet Thoi Trang, Quan Sip Tam Giac K024 - Ca hong - L",69000,69000,5,1,39
34500,33,Ao Thun Form Rong Trai Cay Theu Unisex - A54,103500,69000,4.1,8,13
0,0,AO SO MI DUI NAM,119000,119000,5,1,
0,0,Ao khoac nam nu ni ngoai hoodie logo G chu lung,149000,149000,4,1,1
0,0,Ao So Mi Nam Ngan Tay Dinh Nut Mau GQ01 Thoi Trang TOP FASHION TOP Thiet Ke Tre Trung Va Lich Lam,125000,125000,2,1,4
0,0,Quan ni da ca Amintino Jogger ni nam cao cap am ap,100000,100000,4,3,10
49500,33,Ao Khoac HOODIE WITHECS Unisex - KN82,148500,99000,5,7,8
0,0,Ao thun nam bigsize chu ky,100000,100000,1,1,1
0,0,"Quan au nam, quan baggy den co dan om ong con vai chong nhan cao cap khong bai, xu",100000,100000,5,1,1
0,0,quan short kaki lung thun,69000,69000,5,1,12
0,0,QUAN JOGGER TUI HOP ,199000,199000,5,1,2
0,0,Ao Khoac Du Nam Cao Cap,149000,149000,4,1,
0,0,Quan Short kaki nam thoi trang cuc chat,499000,499000,4,1,1
0,0," Quan lot Nam 3 Mau Aristino Made In Viet Nam, chat thun cao cap (ABF1615)",85000,85000,4,2,6
0,0,"Quan nam kaki slimfit MK CLEVER, ong xuong lung thun - QKT02",195000,195000,4,1,1
0,0,Ao Thun Tay Lo Nam Nu UNISEX JITSU Sieu Dep | Thun Cotton Day Min,69000,69000,4.5,2,2
0,0,"Quan Short Nam kaki Han Quoc - Vai kaki lenin co gian nhe, phong cach, ca tinh, mem min, thoai mai van dong",150000,150000,4.5,2,2
0,0,Bo the thao co dung Amintino ,360000,360000,5,1,2
0,0,"Ao khoac ni nam co mu , hoa tiet hai huoc , cuc dep , hot trend THOI TRANG 1HITSTORE1",79000,79000,2,1,1
0,0,Quan Kaki Nam Cao Cap 2020,169000,169000,4,1,
101000,40,Ao so mi nam kate ford HAHAMAN cao cap SMF1001,250000,149000,4,1,1
0,0,Quan Jogger Lot Ni Nam Panda QNNA-01 - Xam (Free Size),65000,65000,3.8,13,209
0,0, Ao khoac Goku - mau ao khoac Dragonball cuc ngau,267000,267000,4,1,2
0,0,"AO KHOAC DOAN 2 LOP LOGO THEU ( AO GIO DOAN NAM,NU) VAI GIO O SAN DAY AM",186615,186615,5,1,3
0,0,quan short kaki lung thun,69000,69000,4.5,2,4
0,0,Ao khoac du nam cao cap vai du xin chong tham nuoc tot hang chuan shop Phuongnamshop20 kvo1,78000,78000,3,1,1
0,0,Ao thun co co nam nu gia dinh,67620,67620,5,3,3
0,0,"Ao Thun Nam Phan Quang In hinh COM BUOM DEM , ao chat, di dem, di phuot bao ngau, nhin da mat",60000,60000,4.3,14,28
0,0,set 2 quan lot nam dang luoi cai 2 ben,69000,69000,5,4,16
0,0,"Quan short nam loai cao cap, Quan sooc nam QSN003",89000,89000,4,1,3
0,0,"Ao So Mi Nam W&W Dang Regular Fit Co Duc Dai Tay Hoa Tiet Ke Tre Trung- Chat Lieu Tham Hut, Mem Min Cao Cap WLS213R",656000,656000,5,1,1
0,0, Ao Hoodie khung long sieu chat,219000,219000,5,1,1
0,0,"Quan tho nam, quan khaki nam dai  AKK01707",470000,470000,5,1,1
111200,44,"Ao khoac nam JJ03 DO , khoac du nam 2 lop phoi non khong thao roi thoi trang han quoc tre trung cuon hut Julido mau TT01 chat lieu tham hut mo hoi day dan mac thoang mat",250200,139000,3.6,11,40
0,0,Quan Lot Nam Boxer Det Kim Co Gian 4 Chieu Tui Zip Sang Trong - MINHSTORE,21200,21200,5,3,8
0,0,Quan kaki nam tron basic cao cap vai kaki xin hang xuat du Phuongnamshop20 z31,136500,136500,3.3,3,5
144000,44,"Quan Sot Nam, Quan Short Tay Au Nam Co Gian Nhe Dang Om, Quan Ngo Nam Cong So Lich Su Phu Hop Dao Pho Du Lich Thuong Hieu Chandi Ma TA11",324000,180000,4.2,13,20
50000,21,"Ao so mi nam cong so Amazing, chat lieu KT silk nhieu mau, big size, form xuong, dang rong, tay dai",239000,189000,5,1,1
80000,50,Bo do vai thun lanh co gian,160000,80000,5,2,3
90000,31,"Ao so mi nam vai bamboo ke soc, tay dai, vat bau, dang truyen thong, thuong hieu Amazing",289000,199000,5,1,4
0,0,"Ao so mi nam dai tay Xanh Duong(CAM KET DEP) khong nhan, So mi nam gia re",79000,79000,3.7,6,11
99000,19,Ao khoac da nam lot long cao cap AK81 tang vi da cao cap,519000,420000,5,1,1
0,0,Ao Thun Co Do Sao Vang Gia Re cho tre em,29000,29000,4.6,5,10
0,0,Ao Linh - Ao Linh My,460000,460000,4.5,2,1
0,0,Quan jean nam thoi trang hang cao cap,330000,330000,3.3,3,3
0,0, Ao thun Grand Theft Auto GTA cuc chat,145000,145000,4,1,2
0,0,"Ao so mi dui nam co tau form rong mo khuy tay lo, thoi trang phong cach tre",179000,179000,5,1,2
0,0, Hoodie T1 Faker Demon King Champion's cuc chat,239100,239100,5,1,
51000,34,Quan short jean nam xanh den vai dep Q393 Muidoi | quan nam | quan short nam - 31,150000,99000,0,0,228
15100,11,Ao Khoac Du Nam Chuyen Doi Thanh Balo 2 Trong 1 Cuc Chat - AKD32,143100,128000,5,1,4
0,0,"CATSA Ao so mi nau tay dai chat lieu kaki do ben cao, it nhan, khong xu long, mac thoai mai ASC321",400000,400000,4,1,2
14000,7,Ao thun nam ngan tay co tim FREEMAN TSF315 [Combo 2],198000,184000,5,1,1
0,0,"Ao polo nam gau con tay lo, ao thun nam ngan tay co be chat ca xau Cotton - MINHSTORE",99000,99000,5,1,2
0,0,Quan Short Nam Rach️️ Quan Short Bo Nam Cao Cap-QSJN02-Ma 211,139000,139000,3,2,3
0,0,Quan Kaki Nam AVQK05,195000,195000,5,1,4
70000,24,Ao thun nam ngan tay co tron dep chat vai cotton co gian 4 chieu thoang mat ZAVAS  Z11,289000,219000,5,5,8
0,0,"Ao Thun Nam Phan Quang In hinh COM BUOM DEM , ao chat, di dem, di phuot bao ngau, nhin da mat",59000,59000,5,1,7
144000,44,"Quan Sot Jean nam co dan 4 chieu Thuong Hieu Chandi, phong cach han quoc mau moi nhat 2021 HD216",324000,180000,5,47,85
0,0,Ao Thun Nam Phan Quang 7 Mau in Mat Quy ,60000,60000,4.3,14,34
0,0,"Ao Thun Nam Phan Quang In mat Sharingan cua Uchiha SASUKE- hokage bong toi lang La, anime Naruto , ao chat, di dem, di phuot bao ngau, nhin da mat",59000,59000,5,6,14
60000,27,"Ao so mi tay ngan cho nam, vai tole bong sieu mat, vat ngang, dang rong, size lon 105kg, thuong hieu Amazing",219000,159000,5,1,3
0,0,Quan jogger kaki nam nu dang the thao cao cap quan jogger ran ri nam nu thoi trang Minhstore,159000,159000,5,1,2
0,0,"Ao thun wash Nhat Ban thuong hieu GOKING khong dung hang cho nam nu, ao cap doi sieu dep",155000,155000,5,18,33
0,0,AO THUN NAM NO ONE THOI TRANG NHIEU MAU,108000,108000,5,3,5
0,0,Quan kaki nam ARISTINO ong dung - AKKR02,750000,750000,4,1,1
0,0,Ao thun gia dinh  I Love My Family ATGD73,39000,39000,4.6,27,53
0,0,Ao thun thi dau Esports G2 Poland 2021,199000,199000,5,1,
0,0,"COMBO Set Blazer Nam Form Rong Phoi Vien Trang Quan Au Ong Suong Phong Cach Cong So, Thanh Lich Set03 Thoi Trang HERO",427000,427000,5,1,2
0,0,Ao so mi nam dai tay nhieu mau,85000,85000,4.3,4,7
0,0,Quan lot luoi nam,18000,18000,5,9,43
119000,50,"Quan Dui Nam Vai Dui Xuoc Bo Gau, Quan Jogger Nam QD04",238000,119000,5,1,6
0,0,Quan Joger ️️ Quan Jogger Nam tui hop chat lieu Kaki mem min thoi trang To To Shop - JGN6,152000,152000,3,2,2
0,0,"Quan Jean Nam, Quan Bo Mau Moi, Phong Cach Thoi Trang Cao Cap msa6",137000,137000,3,1,3
0,0,Quan Short Dui Thun Nam Ngan Ban Lung To Tap Gym Squat The Thao Di Boi Mac Nha - M179,200000,200000,5,2,6
0,0,Quan Jeans Den Nam Skinny Om Body Chat Co Gian SZone SQ602 ,199000,199000,4,5,6
0,0,Ao Khoac Hoodie Free Fire TEAM HEAVY [ Tang 1 Non Heavy ] Chat Ni Mau Vang Cuc Dep Kieu Dang Han Quoc Tre Trung De Phoi Do Phu Hop Cho Ca Nam Va Nu,189000,189000,5,2,8
0,0,"Ao Thun Nam_ Nu  Phan Quang In hinh CANH THIEN THAN , ao chat, di dem, di phuot bao ngau, nhin da mat",60000,60000,4.3,4,12
44000,34,QUAN SHORT KATE NAM FEZZIO,129000,85000,5,3,15
0,0,"Ao thun tay lo Unisex, ao phong form rong ATL212  - Yinxx",69000,69000,5,1,1
0,0,Quan boi nam chong tham nuoc sieu re co gian tot phong cach nang dong co day rut  QB6099A,45000,45000,4.5,34,109
0,0,Ao Vest nam thoi trang,499000,499000,4,3,6
50000,22,"Ao so mi nam Amazing, so mi cong so, tay ngan, nhieu mau 48112-02",229000,179000,4.3,4,11
0,0,Combo 5 quan lot nam/ sip nam cao cap - mem min sieu thoang - H01,140000,140000,4,4,4
0,0,"Quan au nam, quan baggy den co dan om ong con vai chong nhan cao cap khong bai, xu nhan, cam ket dep",80000,80000,5,1,8
0,0,"Quan Au nam, Quan Tay nam loai dep vai khong xu nhan QA001",89000,89000,4.3,3,14
0,0,Ao Thun Nam Phan Quang 7 Mau Dua Tay Nao,60000,60000,4.6,40,117
0,0,Ao Free Fire [HANG MOI VE] 3D Mau Den Team Heavy 2020,89000,89000,4.6,46,124
71000,28,"Ao so mi nam co tru chui dau dai tay form rong ArcticHunter, chat dui thoang mat, thoi trang thuong hieu chinh hang",250000,179000,4.2,11,22
80000,24,"Ao so mi nam Amazing, hoa tiet nho, tay ngan, vat ngang, dang rong, sang trong-50122-02",329000,249000,4.3,7,9
0,0,"Combo 3 Chiec Quan Lot Nam Boxer Chat Lieu Cotton Cao Cap CALUCI CA - 02 Nang Dong, Nam Tinh (Giao Mau Ngau Nhien) - Hang Chinh Hang",390000,390000,4.7,21,37
79200,44,"Ao thun nam co tron tay ngan tre trung, chat lieu cotton cao cap mau THUU23",178200,99000,4.3,7,30
0,0,AO THUN DAI TAY NAM,149000,149000,4.3,22,49
0,0,Ao vest nam form om body mau den chat vai mem min may dung chuan 2 lop dung va don vai co tui trong va ngoai (size M),210000,210000,2,1,2
0,0,Ao Thun Nam Nu -SWE - Logo 2016 - Den -Chat Lieu 100% Cotton Du Size Thoi Trang Cao Cap,330000,330000,4.5,33,80
28000,12,Combo 3 Quan Lot Boxer Nam Freeman 6517-CB3,237000,209000,5,5,65
0,0,Ao khoac phao nam lot long AN205,990000,990000,1,1,
0,0,Combo 2 Quan Dui Nam JME JMB009 (Freesize),169000,169000,3,3,8
66000,20,Combo 5 Quan Lot Nam Freeman 6046-CB5,325000,259000,4.6,9,59
0,0,Ao khoac HOODIE ni tron unisex bassic KNT01,59000,59000,1,1,
0,0,Ao Thun Nam Cotton Body Cao Cap Co Gian Tot,139000,139000,3.9,13,137
0,0,Quan Jogger Nam Nu 3 Soc Form Ong Rong De Xuong Hoac Rut Day Bo Gau Vai Min Nang Dong Tre Trung,88000,88000,4,2,3
116000,44,Ao so mi nam caro cao cap dai tay SM092,265000,149000,4.3,3,22
0,0,Quan Dui Nam Ngan Den Tron SHORTDEN98,111000,111000,1,1,
0,0,Ao thun nam unisex phong rong hoa tiet sieu hot (UX-05-01),49000,49000,4.1,15,31
127200,44,"Quan jeans nam co dan , quan bo nam kieu tron rach goi dang vua khong bo sat thiet ke tre trung don dieu pha cach gom 5 kich thuoc (28-32) Julido mau QJNM015 - Mau Den rach goi",286200,159000,4.5,24,42
155200,44,"Ao khoac jeans nam , ao khoac nam xam GT01 form vua chat lieu mem mem co dan loi cuon co mu co 3 size Julido mau khoac AKJ8687 thoi trang lich lam han quoc tre trung hien dai",349200,194000,4.3,28,90
0,0,Ao thun nam unisex phong rong hoa tiet sieu hot (UX-05-15),50000,50000,4,20,92
0,0,Ao So Mi Nam Ke Soc Caro Khong Nhan,200000,200000,3,3,3
0,0,Combo Ao + Non Ao AMong Us Mau Den Hinh Do Hinh In 3D Sac Net TANG 1 Non Theu AMONG US Chat Lieu Kaki,95000,95000,5,2,8
0,0,Ao so mi nam tay dai lua dui X35,252000,252000,5,3,3
0,0,COMBO 4 quan lot nam cao cap chat cotton ke ngang tre trung QA389,160000,160000,4.8,4,5
59000,50, Tee BOBUI SAIGON phan quang  - Ao thun unisex 100% cotton cao cap,118000,59000,0,0,1
0,0,"[AO THUN HOT TREND] AO THUN UNISEX TAY LO PHOM RONG NAM NU Hot Trend- AO THE ZED- Free size 40-70kg - ALOHA STYLE - Chat lieu vai tham hut tot, thoai mai van dong",82000,82000,5,4,10
0,0,AO THUN NAM DAI TAY NI DA CA PHOI MAU ,297700,297700,5,1,1
0,0, Combo 4 quan lot nam thun lanh cao cap sieu nhe chim co hoa la,137000,137000,4.7,3,7
0,0,Quan Dui Nam Vai Cotton Ke Karo Mem Size 50-80kg,35000,35000,3,2,8
205000,46,"Quan jogger tui hop nam chat kaki mem min, phong cach duong pho A2",450000,245000,4.7,3,5
0,0,Ao khoac Free Fire mau den in hinh Booyah,159000,159000,4.5,15,33
111200,44,Ao khoac nam chat du 2 lop xin xo Julido Store mau moi theo xu huong thoi trang Trend007,250200,139000,4.6,9,38
111200,44,"Ao so mi nam form rong Julido Store, chat lua thai cao cap xu huong moi nhat mau QLA1",250200,139000,3.2,26,52
650000,50,"Bo vest nam 1 nut om body mau trang chat lieu co dan , thoang mat tang kem combo phu kien",1300000,650000,3.3,3,5
0,0,Ao boi tay dai chong nang TYR Streak Long Sleeve Rashguard,795000,795000,5,3,17
81000,32,Ao thun ao phong polo nam ngan tay co co hoa tiet TKAHT27 PigoFashion chon nhieu mau,250000,169000,5,2,6
61000,41,Ao tanktop ba lo ao sat nach nam TKASN01 PigoFashion giao mau ngau nhien,150000,89000,5,1,2
0,0,Ao So Mi Nam Dai Tay Ke Caro BBR Mau Xanh Chat Lua Tho Mem Cao Cap Dang Body Han Quoc Tre Trung Nang Dong ,279500,279500,5,2,3
0,0,Combo 6 Quan Lot Nam Thun Lanh X-Men Underwear MS1035,119000,119000,4.1,9,56
0,0,"Ao thun polo nam hieu GOKING, vai thun ca sau cao cap",165000,165000,4.8,38,238
0,0,Ao giu nhiet cao co DOL nam lot bong ben trong,59000,59000,0,0,
0,0,Ao So Mi Co Tru TITISHOP SM525 - Vang,69000,69000,4.2,5,25
0,0,Ao thun NASA co in logo tren tay ao,135000,135000,5,1,6
0,0,AO SO MI NAM PHOI 2 TUI CUC DEP,219000,219000,4,3,5
0,0,Ao gio nam,580000,580000,4,9,49
0,0,Ao Vest Nam Titishop VN40 - Trang,550000,550000,2,1,2
0,0,"Ao So mi KUPI Nam Nu Unisex tay dai, vai nhung tam form rong, khong nhan",159000,159000,5,4,6
0,0,"COMBO 5 Quan short nam Quan dui nam thoang mat mua he,phong cach thoi trang,tre trung",85000,85000,4,1,2
0,0,Quan jean nam trang,99000,99000,4.6,11,60
0,0,Ao Thun/ ao phong Tay Lo Unisex Henri Matisse  vai cotton mau DEN/ TRANG Nam nu unisex/  99K ,109000,109000,4.3,3,8
0,0,"Ao khoac cardigan len nam co khoa keo lot ni am ap, thoi trang thu dong 2020",320000,320000,5,3,11
0,0,Ao thun polo nam the thao soc ngang co co vai ca sau thun thoang mat trung nien Nexx & Dee ND03,139000,139000,4.5,34,78
0,0,Ao thun nam nu Unisex thoi trang mau Khung Long Xanh Cuc chat AT104,25000,25000,3,1,1
81000,32,Áo khoác dù nam Hahaman dáu nón 2 lóp lót nỉ sành cao cáp AKD45,250000,169000,4.5,6,7
0,0,SALE 50% BST combo ao thun + quan short Naruto Akatsuki Itachi Uchiha tang kem kt cuc HOT,199000,199000,5,1,1
0,0,Ao thun in hinh Vua Su Tu Lion King - Form rong BIGSIZE F2192,75000,75000,2,1,1
0,0,SALE- Ao thun ao phong Yuno x Asta - Black Clover gia sieu re nhat vinh bac bo - gia tot nhat,108000,108000,4,1,1
0,0,"Ao Gio Lot Cotton Vai Van Gao Cao cap Pmax Nam Nu, 2 Lop, Mu Thao Roi, Chong Nuoc, Chong Gio, Chong Nang, Phom Tre Trung",259000,259000,5,14,20
0,0, Bo dui nam chat day dan bo vai dui nam khong nhan,139000,139000,5,1,5
0,0,Quan au Vulcano 7009,149000,149000,5,1,4
0,0,Quan lot nam boxer cao cap LN007,83000,83000,3.5,2,8
0,0,Ao thun polo nam soc ngang co co be vai ca sau cao cap trung nien ND03,139000,139000,4.8,4,9
0,0,Quan short nam tui hop day keo tien loi dung duoc nhieu do,179000,179000,3.5,6,10
650000,50,Bo vest nam 2 nut form suong mau xam ghi,1300000,650000,5,1,3
0,0," Ao khoac gio Kwin cao cap, dang the thao, chong tham nuoc nhe, can gio han che bam bui",625000,625000,1,1,1
0,0, Ao len nam BITULA,120000,120000,4.7,3,9
0,0,quan short kaki cao cap_moden moi nam 2020,57500,57500,4.5,2,5
0,0,Ao khoac nam gia Vest Cotton dang slim vua van tre trung chat dep,350000,350000,4.5,8,16
0,0,"Ao thun nam Polo co be hoa tiet gau GYPSY Bear chat Poly thoang mat, co dan - FEAER DENIM",339000,339000,5,1,1
159200,44,Ao Thun Polo Nam Co Be Tay Ngan Ke Soc 3 Mau Thoi Trang Men Luxury PL56,358200,199000,5,4,8
0,0,quan bo nam,400000,400000,5,1,1
0,0,Quan Kaki Nam Aristino AKK005S7 Mau Sac Nha Nhan Lich Lam - Hang Chinh Hang ,695000,695000,5,4,6
0,0,Bo 2 ao thun body ba lo nam Taki Taki,109000,109000,3.7,12,47
0,0,"Quan au nam loai dep, quan tay nam Mau Ghi Xam QT009",99000,99000,5,1,11
0,0,Ao so mi nam ngan tay Xanh Nhat SMT03,79000,79000,4.5,5,11
0,0,"Ao thun nam phong tron Casual 1st co tron tay ngan coc, vai 100% cotton cao cap thoang mat, tham hut mo hoi, form ao tre trung thich hop di lam, di choi, dao pho, du lich, Made in Vietnam - LetterA",250000,250000,5,1,1
0,0,"Combo 5 Quan Sip dui nam chat cotton, thoai mai, thoang mat",76800,76800,0,0,
0,0,Ao gio nam 2 lop,150000,150000,4,1,1
0,0,AO KHOAC GIO NAM 2 LOP VAI DU - ANH THAT PHIA SAU AKG01,229000,229000,4.5,2,2
0,0,Sip duc nam cao cap - Sip boxer nam - sip lua duc khong duong may sieu mat,35900,35900,4,1,24
0,0,AO KHOAC DA NAM LOT LONG -NAU,648700,648700,4,1,1
0,0,"Quan Tay Nam Han Quoc, Quan Au Nam Cao Cap Mau Xanh Than, Chat Vai Lua Khong Nhan ( Cam Ket Dep )",234000,234000,4,1,10
0,0,Ao so mi viet tien tay ngan xe ta lai ngang 0003,515000,515000,5,1,2
0,0, Ao Thun Nam Free Fire Den 3D - Rank Dai Kien Tuong,123201,123201,1,1,2
0,0,Viettien - Ao so mi nam dai tay ke soc vat bau 1P1162 regular,475000,475000,5,1,1
0,0,"Do bo Pijama nam coc tay chat vai COTTON 100 day gian, thong thoang (604)",410000,410000,5,2,6
0,0,Ao so mi nam viet tien dai tay cham bi 1P0727,580000,580000,5,1,
0,0,ao am lot ni cho bo cho ong (SM),295000,295000,5,1,3
0,0,(HOT) Ao Thun Nam Co Be Ca Sau Co Co Dep Cao Cap,286000,286000,5,1,
0,0,"CATSA Ao so mi xanh duong chat lieu vai Oxford mac cuc mat, tham hut mo hoi va thoai mai ASC318",380000,380000,4,1,1
0,0,"Ao Phong Tron Nam Cotton, Phom Dang Dep, Nhieu Mau Sac Lua Chon AL39",69000,69000,4,1,1
159000,28,"Bo 4 ao thun nam co be cao cap DokaFashion, chat lieu thun ca sau 4 chieu ngoai nhap - Xanh mon, Xanh den, Den, Xanh co vit",558000,399000,4.6,5,17
70000,23,"Quan tay nam mau xanh den, ong dung, khong ly, dong phuc hoc sinh, cong so, thuong hieu Amazing, co size 100kg",299000,229000,5,2,17
0,0,AO SO MI NGAN TAY NAM CUC HOT PHONG CACH DANH CHO DAN CHOI THOI TRANG 1HITSTORE1,97000,97000,3.5,2,11
0,0,"Ao thun Polo nam co be chat lieu vai cotton xuat xin mau tre trung don gian ,phong cach hien dai-JD42",159000,159000,5,1,2
0,0,Ao Khoac Du Nam Khoa Dong  Pil-ot Phi Cong,285000,285000,3,6,15
0,0,"Ao phong nam dang Body tre trung, ao thun nam co be chat lieu thun cao cap tham hut mo hoi",105000,105000,0,0,
0,0,Ao khoac nam da lon lot long Sieu Am,325000,325000,3.2,5,6
0,0,"So Mi Tay Lo 1 So Mi Ngan Tay Nam, Nu Hang Unisex Form Rong - Mac La Dep - Ma smcv",109000,109000,5,1,2
0,0,Quan jean nam tron cao cap vai jean co dan hang chuan shop Phuongnamshop20 kvp20,124100,124100,4,1,3
0,0,Quan Sip Nam Duc Su Cao Cap Nhat Ban,59000,59000,5,1,5
0,0,AO THUN NAM NU MEO DAI CA DEO VONG VANG SIEU NGAU MAU MAC 4 MUA AT06,28600,28600,1,1,1
0,0, Ao thun tron nam form rong vai poly cotton cho moi lua tuoi NHIEU MAU SIEU SALE,13200,13200,0,0,
0,0,Quan tay Hoc sinh BigSize vong bung 102cm,117000,117000,5,1,3
0,0,Ao khoac bomber Resuapre TAY DA Varsity Jacket Red nam Kunshop,650000,650000,2.5,2,2
0,0,Ao Hoodie Nam Nu Dang Rong - Ao Ni Co Mu Exchange,170000,170000,3,1,1
0,0,"(Size den 120kg) Quan jogger kaki nam nu chat dep, co gian",180000,180000,5,2,2
0,0,Quan jogger kaki zipper nam nu deu mac duoc chat kaki day dan,160000,160000,4,1,1
55000,31,Quan Short Dui 3 Soc unisex N7 the thao basic nam nu oversize phong cach duong pho Han Quoc ,180000,125000,5,1,1
101000,40,"Ao thun Sweater Nam Nu dai tay ni Cao Cap Ban Tay Dirty Phan Quang (Trang, Den), form rong ca tinh, phong cach thoi trang Unisex",250000,149000,5,1,1
0,0,Hang cao cap | Bo vest nam 6 cuc Han Quoc mau den sang trong - DUKI STORE,799000,799000,5,1,4
0,0,AO KHOAC DU 2 LOP NHIEU MAU SAC SINH DONG,99000,99000,5,1,
0,0,Ao SWEATER Ni Thu Dong dai tay Phong cach Han Quoc N04,148000,148000,2,1,
0,0,Ao Len Nam co tron dai tay Tieu Day Thoi Trang FAVITI AL77,145000,145000,5,1,
0,0,Ao So Mi Nam Dai Tay Hai Soc Ngang,125000,125000,4,1,1
210000,42,"Ao vest blazer Linen nam dang lung, chat vai linen tu nhien mem mai, thoi trang phong cach lich lam - Trang",500000,290000,3.6,20,49
0,0,Ao Khoac Du Nam Co Non Phoi Tui Bonado AK27,159000,159000,5,4,14
0,0," Ao dui co tau coc tay, ao dui nam cao cap thoang mat mua he 2021",156000,156000,5,1,1
0,0, Quan jeans nam ong om MESSI SJM-767,480000,480000,5,1,1
0,0,AO HOODIE NAM NU IN TRAU VANG KONGFU SIEU CUTE,110000,110000,1.7,3,9
0,0, HOODIE Luffy Ace One Piece cuc HOT khuyen mai khung gia re dep,310000,310000,5,1,1
0,0,Combo 6 Quan Lot Nam Tam Giac Thun Lanh Vinh Tien QL-03 - Nhieu Mau,450000,450000,5,2,9
0,0,"Do bo the thao nam chu A vai thun lanh mem min, Thoi Trang Phong Cach Han - Lee’s Home (Freesize tu 45-70kg)-Nhieu kieu lua chon",117000,117000,4.7,3,5
0,0,"Ao Polo nam trung nien co tui phoi soc vai ca sau Cotton xuat xin,chuan form,sang trong-lich lam ",159000,159000,5,1,8
0,0,Ao Polo Nam Co Tui Ao Polo nam trung nien phoi co be co tui vai ca sau Cotton xuat xin chuan form rong thanh lich,159000,159000,3,1,
53000,48,quan short nam cap chun chat dui lua mem mat,110000,57000,4.8,12,17
0,0,Ao Khoac Kaki Jean Cuc Chat (mau vang) - New Hot 2021,35200,35200,5,1,1
0,0,quan tay nam cong so,119000,119000,5,1,1
0,0,QUAN SUONG NAM ONG RONG - Ma 095,189000,189000,5,1,
0,0,Ao So Mi Nam lua hoa la cao cap xu huong moi nhat nam 2021 ,95000,95000,1,2,3
0,0,Somi ME.NDE KNIGHT ANGLES - So mi Lua CNK 100%,159000,159000,1,1,1
0,0,AO SO MI VAI DUI NHAT CAO CAP SANG TRONG THOI TRANG,75000,75000,3,1,1
0,0,"Ao len nam co 3 phan Han Quoc, chat len day dan, hang nhap Quang Chau",320000,320000,3.5,2,3
0,0,Ao Sweater Thoi Trang Nam Nu Phong Cach Basic In Hinh Con Thu Dang Yeu - LZGV037,109000,109000,4,7,19
0,0,Quan lot nam cao cap ROCK SEAMLESS,136000,136000,4,1,
121000,58,Ao so mi nam soc mau cao cap ngan tay,210000,89000,5,1,3
169000,34,Set 3 ao thun nam ca sau co be pious xanhtrangxam,499000,330000,1,1,2
0,0,"Squid game ao thun so mac ben trong,mau squid game tro choi con muc DT036",78000,78000,5,2,13
0,0,Ao Phong ao thun Phong Can TV -Hero Among Hero Team,115000,115000,5,1,1
0,0,Ao so mi Hoa tiet TITISHOP SM1124,350000,350000,5,1,1
0,0,"Ao lot nam cao cap GOKING, ao thun ba lo nam 100% cotton thoang mat, tham hut mo hoi, khu mui, khang khuan",139000,139000,4.8,31,151
0,0,"Quan Jogger Kaki Nam FAJA Phong Cach The Thao, Tre Trung - Mau Xanh Reu",85000,85000,3.8,174,962
0,0,Ao Khoac Nam Jean / Denim Jacket - AKB1 Xanh Bo,160000,160000,3.6,9,18
0,0,"Ao thun nam co be vai ca sau, Combo 2 ao – EZ232",269000,269000,5,2,6
219000,35,"Ao Thun nam cá sáu mãu mói, combo 4 áo - DB437",623000,404000,4.5,44,94
0,0,Quan shorts nam kaki,99000,99000,3.4,14,295
0,0,Ao khoac nam trung nien hang cao cap ( kaki chat luong cao) ,410000,410000,4,3,29
0,0,Ao khoac phao nam AN120,500000,500000,1,1,1
0,0,Ao khoac ni Hoodie Hot,39000,39000,3.7,39,115
0,0,Quan Shorts Kaki Nam Tui Hop,179000,179000,4.1,16,75
131000,44,Bo ni nam thu dong Kojiba dang om chat ni da ca cao cap,300000,169000,3.2,22,237
0,0,"CATSA Quan jogger den chat lieu du nang dong, thoai mai, dang chuan QTJ031",520000,520000,5,1,
102000,51,Ao Thun Tay Ngan Nu Nam URBAN OUTFITS In Minimal ATR07 Dang Suong Cotton 4 Chieu,200000,98000,5,1,
0,0,Quan Dui Nam 5S/ SS Vai Gio Quan the Thao Short Nam 5S Chun Mem Mai - MINHSTORE,49000,49000,3,2,5
15200,10,Ao khoac du nam co dung hai mat cao cap AKD0136,159200,144000,4,1,
0,0,Ao Gile Nam Ran Ri Phong Cach Linh ARMY,0,245000,4.2,12,
111200,44,Ao khoac nam chat kaki 2 lop xin xo Julido Store mau moi theo xu huong thoi trang Trend003,250200,139000,4.2,5,27
0,0,"Ao khoac One Piece Luffy K05, Ao khoac hoodie Anime Manga One Piece Monkey D. Luffy Unisex Nam Nu",220000,220000,4.3,3,4
0,0,Ao hoodie form rong phong cach Han Quoc nang dong cho cap doi M4,149000,149000,4,1,2
0,0,Ao Polo Basic Nam Couple TX MPO 1011,399000,399000,4,1,6
0,0,Ao thun Teeworld Outer Space T-shirt Form Rong Unisex Nam Nu,359000,359000,5,1,1
96000,15,OWEN - Quan au nam cong so dang SLIMFIT cap Tang do co dan soi NANO ma QST22764,625000,529000,4,2,2
0,0,"Ao so mi nam dai tay vai lua co gian thoang khi, so mi nam co tau chong nhan chong xu, size ao tu 45-80 kg, giat duoc may giat, 2 mau den va trang",0,99000,4.7,3,
0,0,"Ao ghile cong so, ao gile dong phuc, ao ghi le nam Z10",239000,239000,4.7,6,17
0,0,Ao thun nam nu in hoa tiet phong cach sieu hot ASALA (ux-2064),59000,59000,4.7,3,7
0,0,"Combo Ao Khoac , Khan Bit Mat Den Tron Alan Walker",180000,180000,3.5,21,238
0,0,Quan Short Thun Nam Tap Gym Di Boi Mac Ngu Ngan Om Ngang Dui - MM127,200000,200000,4.2,12,123
0,0,"Ao khoac gio nam nu phoi 3 mau, vai du mong nhe, tien loi, thich hop di phuot",189000,189000,4,12,30
0,0,Ao Thun Nam Cotton Xanh Reu ,129000,129000,4.1,7,24
79000,50,COMBO 3 Ao thun tron nam form rong phong cach han quoc vai poly cotton min MAU DEN-TRANG-XAM SIEU SALE !! SIEU SALE !!,158000,79000,3.1,7,26
0,0,"Ao khoac jeans nam in chu sau lung co non phong cach,ca tinh manly",159000,159000,5,12,41
0,0,Ao Khoac Hoodie Trum Dau Unisex HD-011,129000,129000,4.6,9,20
0,0,Ao so mi nam ke Caro loai dep KCR003,118000,118000,5,1,20
0,0,Quan dui dai nam ong con cap chun cai cuc - Quan nam dang xuong tre trung mac mua he,49000,49000,1,1,9
0,0,Quan Short Nam Rach️️ Quan Short Bo Nam Cao Cap - Sot Jean Co Gian Mau Moi Hang VNXK To To Shop-QSJN13-Ma 206,139000,139000,5,1,1
0,0,"BIG SIZE Ao so mi nam LAVIC-523 vai Lua thoang mat, khong nhan form suong",159000,159000,5,1,9
145000,38,"Ao khoac nam co non AK01, vai Xi Nhat cao cap day dan, chong tia UV, chong nang, co lop cach nhiet ben trong giu am tot",380000,235000,5,1,1
0,0,"Quan short thun nam nu Yinxx, quan sort Unisex phong cach ulzzang QS52",79000,79000,5,1,3
199000,50,Ao gile nam om body mau den chat lieu vai day min,398000,199000,5,1,4
0,0,Combo Ao + Mu luoi chai Ao thun mau den in hinh Quy Vuong Free Fire tang 1 non luoi chai theu cao cap mau den cuc chat,109000,109000,5,3,21
0,0,GIAM 75% Bo vest nam cong so 1 cuc dep mau xanh than gia sieu re - DUKI STORE,649000,649000,5,1,5
0,0,Ao khoac nam kaki chong nang - from rong tron ,114000,114000,5,1,5
0,0,"Quan Short Jean Nam Ngan , Quan Bo Lung Nam Co Gian Sieu Chat OBOK Fashion QSN01",149000,149000,5,2,6
0,0,Quan Dui Chun,100000,100000,5,2,2
0,0,Combo 3 ao thun nam cao cap mau ngau nhien CB3ATN,99000,99000,2,1,7
0,0,ao len nam co 3p Quang Chau cao cap,350000,350000,5,1,
0,0,Ao thun hoa van co trang Trung Quoc phong cach Unisex nam nu,43000,43000,3.9,27,55
0,0,"Ao thun Nam Nu Khong co NARUTO TEAM 7 MSOP-02 mau moi cuc dep, co size be cho tre em / ao thun Anime Manga Unisex Nam Nu, ao phong thiet ke co tron basic coc tay thoang mat",35000,35000,4,1,3
0,0,"Ao thun Nam Nu Khong co ONEPIECE NANG LUC LUFFY  MSOP-20 mau moi cuc dep, co size be cho tre em / ao thun Anime Manga Unisex Nam Nu, ao phong thiet ke co tron basic coc tay thoang mat",39999,39999,5,1,1
0,0,Ao Khoac Kaki Nam Lot Caro Phong Cach Cho Moi Lua Tuoi,179000,179000,5,2,2
0,0,"Ao Croptop Nu 3 Lo Polo , Ao Crt Nu Sat Nach Co Be 2 Mau B019 - Reso Shop - zeni69 store",70000,70000,5,2,3
20000,16,"Quan Jogger Ni Vien Noi Tron Unisex , Ong Bo Chun Theu Logo 3 Mau C011 - zeni69 store",125000,105000,5,1,
0,0,Ao So Mi Nam Tay Dai Slim Fit Titishop SM537 - Xanh Da Troi,79000,79000,4.5,6,155
0,0,Ao thun polo nam co co be ca sau soc ngang big size ND02,149000,149000,4.7,7,18
0,0,"Quan Sot Dai nam phong cach, Quan Short Dai",69000,69000,5,1,1
0,0,Ao thun nam nu cao cap vai cotton xin co dan vai mat mau hot 2021 Phuongnamshop20 m38,75900,75900,5,1,2
0,0,Quan Jean Nam Thoi Trang Tre Mau Den Rach Cao Cap ms0101,137000,137000,5,3,7
0,0,AO GIO NAM CAO CAP ZAKADO (ZJK202),695000,695000,5,1,4
0,0,Quan shorts di bien nam SQ211 Xanh,149000,149000,4.3,4,14
0,0,AO KHOAC DA NAM,369000,369000,0,0,2
60000,16,"Ao khoac len nam co tru tre trung ArcticHunter, thoi trang thuong hieu chinh hang",380000,320000,5,2,5
0,0,Quan Jean Nam Xanh Trang Phoi Rach QD014,225000,225000,5,1,1
0,0,Ao Thun Nam In Hinh YouTube Everest AokNAM396 (Xam),195000,195000,4.1,13,87
0,0,Ao Thun Nam Trang In Hinh Zalo Everest Aoknam397 - Xanh La Nhat,195000,195000,5,2,6
0,0,Ao Thun Nam Everest AoKNAM363 - Xanh Nhat,238000,238000,5,1,1
34000,43,Ao Thun Nam Everest AokNAM419 - Trang,79000,45000,5,1,26
0,0,Ao Thun Nam Everest AoKNAM336 - Xanh Nhat,238000,238000,5,1,9
0,0,QUAN THUN NAM NI BO ONG DAY DAN,99000,99000,1,2,2
0,0,Ao thun tay lo Nomac Unisex in hoa tiet dep Phi Hanh Gia AT0715/ Freesize/ Phu hop ca nam va nu.,53000,53000,5,19,35
0,0,"Ao so mi nam tron, tay dai - Den - S",63000,63000,5,1,144
40000,30,"Quan short tthun nam 2 soc dui LAHstore, chat cotton mem min tham hut mo hoi, thoi trang tre.",135000,95000,3.5,6,14
40000,17,"Quan jogger linen nam cao cap LAHstore, chat vai linen mem mat, thoi trang phong cach Han Quoc",239000,199000,3.3,3,6
40000,17,"Ao so mi nam co tau linen mau tui nguc pha vai tre trung LAHstore, thoi trang phong cach lich lam",229000,189000,3.7,6,11
40000,27,"Ao so mi linen nam co tau tay coc LAHstore, thoi trang xuan he 2021",149000,109000,4.8,6,17
127200,44,"Ao Thun Nam ngan tay co co mau trang thuong hieu Chandi, Ao Polo Nam the thao chat lieu thun cotton cao cap tham hut mo hoi NT459",286200,159000,5,10,16
7800,5,"Quan Dui Nam dai, quan dui dai nam cap chun",156000,148200,4.3,4,5
0,0,quan short kaki nam phong cach tre,129000,129000,3,2,13
0,0,Quan Dui Di Bien Nam Dep,119000,119000,4.3,29,167
51000,9,Ao khoac da nam lot du cao cap TKADN10 PigoFashion chon size,550000,499000,5,2,3
0,0,AO THUN NAM POLO CAO CAP CO BE,149000,149000,4.5,4,9
70000,28,Quan Short Dui ESSENTIALS unisex N7 thun Basic nam nu ong rong Han Quoc,250000,180000,5,1,
0,0,QUAN NI JOGGER CO DAN 4 CHIEU HANG CHONG XU,150000,150000,5,1,
0,0,Ao so mi nam hoa tiet tho cam sang trong T3A12,141000,141000,2.3,4,9
40000,13,"Combo 2 quan dui nam phoi mau LAHstore, chat dui mem mat thich hop mua he, thoi trang tre.",317000,277000,2.9,10,24
0,0,"AO KHOAC DU BOMBER 1997 HOA TIET CHU IN HINH TREN AO SIEU NGAU,DAM CHAT MUA HE CHO CAC BAN NAM ",96000,96000,2.5,2,3
81000,34,"Ao thun polo nam in hoa tiet cham tron, vai cotton ca sau, chuan form dang dep PPL31-1 nhieu mau PigoFashion",240000,159000,4,4,6
0,0,"Combo ao + mu, Ao thun den Free Fire in hinh Alok Tang 1 non luoi chai Free Fire Ao thun du size phom danh cho ca nam va nu",109000,109000,4.5,48,135
0,0,"Ao Da Nam, Ao Khoac Da Nam dang dai thoi trang Han quoc -AKD05",379000,379000,5,3,10
0,0, Quan Baggy Nam Nu KAKI Ong Suong Unisex-BG01,89700,89700,5,2,7
0,0,"Ao Polo Nam Feaer Basic FEAER DENIM Form chuan, Chat Cotton 100%, Ao Tron Trang / Den",229000,229000,5,8,22
0,0,Ao khoac len nam thoi trang TK11A3026,79000,79000,4,3,22
0,0,"Ao khoac jean may 3 mac noi, ao khoac bo nam phong cach han quoc unisex",127000,127000,0,0,
0,0,combo 3 thun 3 lo nam dep loai cotton loai 1 mem min mat hut mo hoi cuc tot,79000,79000,4,1,1
127200,44,"Ao So Mi Nam lua phoi hoa tiet cao cap Thuong Hieu Chandi, xu huong moi nhat nam 2021 mau SM6",286200,159000,4.5,12,17
0,0,{SIEU PHAM MUA DONG} AO KHOAC NAM/AO KHOAC PHAO NAM TRAN BONG 3 LOP SIEU AM AP MUA DONG CO SIZE 3XL ,150000,150000,3.5,6,17
0,0,"Quan Shorts Kaki Nam Vai Dep, Ben Mau LD 44",55000,55000,3.7,10,44
0,0,"Quan tay au nam loai vai day, co dan LD09",119000,119000,1,1,2
0,0,QuAN DAI KAKI TRUNG NIEN ONG DUNG,109000,109000,3.8,25,59
0,0,Combo 4 Sip Duc Nam Lua Sua Cao Cap Vai Sieu Mat thiet ke U Loi phia truoc mac Thoai Mai De Chiu - Nhieu Size Nhieu Mau de lua chon,319000,319000,3.6,10,32
0,0,"Quan Lot Nam, Quan Ngu Nam",99000,99000,4.3,11,61
0,0,Quan Short Nam Tui Hop ( size 28-36),179000,179000,3.5,14,25
0,0,Quan short jean nam xanh den vai dep Q393 Muidoi | quan nam | quan short nam - 28,90000,90000,5,1,5
0,0,Quan short jean nam xanh den vai dep Q393 Muidoi | quan nam | quan short nam - 28,90000,90000,5,1,5
120000,29,Ao Hoodie Nu Nam Form Rong URBAN OUTFITS In Trai Tim UO Universe HOO15 Chui Dau Thun Cotton Ni Local Brand,420000,300000,5,3,4
0,0,Ao Khoac Nhe Nam Chong Nang Thong Hoi UVDEN03 - Chong Nang Den,200000,200000,4,1,1
86000,40,"Ao Khoac Di Nang, Chong Nang Co Mu Cho Nam CN11-Cotton Thoat Mo Hoi ",215000,129000,5,3,5
0,0,Ao Chong Nang Danh Cho Nam Thoang Mat Chong UV CN11 Cao Cap,119000,119000,0,0,
17500,25, QUAN BOXER NAM QX387,70000,52500,3,1,8
0,0,QUAN BOI NAM CAO CAP QT231,180000,180000,4.3,4,18
0,0,Ao khoac linh US ARMY 3313,169000,169000,3,2,4
15000,10,QUAN BOI NAM TRON MAU QT205,150000,135000,3,1,2
0,0,BO DO PIJAMA NAM THUN COTTON QSHOP QM185-QM186-QM187,350000,350000,1,2,3
0,0,Quan Short Nam Rach️️ Quan Short Bo Nam Cao Cap QSJN10-Ma 204,139000,139000,5,2,2
7900,10,Quan lot bikini Seahorse Underwear SH036,79000,71100,4.3,3,4
0,0,Ao khoac nam ca tinh  3313,462000,462000,4.2,35,89
0,0,"Quan kaki nam lung thun, quan nam co BIG SIZE den gan 100kg, NHIEU MAU - NH Shop",149000,149000,4.1,9,15
0,0,Ao Ni Nam The Thao Thoi Trang Tre Trung Chat Vai Co Dan ROUGH 5 Mau Da Dang,139000,139000,4.3,11,20
0,0,Ao co lo nam TP13,74000,74000,0,0,2
0,0,Ao khoac gio cho nam dong cao cap,95000,95000,5,1,8
0,0,Ao hoodie mu trum HADES - TEMPTATION,550000,550000,5,8,19
0,0,Ao Khoac Du Bomber Unisex mau Moi,105000,105000,0,0,
0,0,Ao Hoodie Ni Bong in Vu Tru - Form Rong Unisex Nam Nu ulzzang KUN,97000,97000,5,1,1
0,0,Ao thun nam nu BIGSIZE tu 50kg den hon 120kg NHIEU MAU - NH Shop,89000,89000,5,1,2
0,0,Ao Khoac Du Nam Kieu Bomber,189000,189000,5,2,4
161000,47,Jogger tui hop THE 1992 Quan dai kaki the thao,340000,179000,5,2,2
126000,49,"Combo 2 quan the thao Sport vai Thun Poly 2 Da thoang mat, hut am tot, do co gian cao - Mau den va trang",255000,129000,5,4,13
0,0,do bo the thao nam han quoc mac nha,95000,95000,4.8,12,33
0,0,Ao hoodie ni ngoai in chu,95000,95000,5,3,6
285000,75,"ao hoodie in phan quan, ao hoodie ulzzang, ao hoodie ca tinh, ao hoodie nam nu deu mac duoc",380000,95000,3.5,2,4
0,0,Ao Sweater Unisex Han Quoc form rong chat xin mac thoang mat,89000,89000,5,1,3
73000,50,Do bo nam nu unisex mua he chat me xin co gian 4 chieu thoang mat (Skate),146000,73000,4.5,13,30
99600,40,Ao Thun Nam Couple TX In Vinh Ha Long MTS 1002,249000,149400,5,1,2
0,0,Ao thun 3 lo nam Model Fashion cao cap  MDA001,59000,59000,2.3,3,7
0,0,Ao khoac da nam lot du thoi trang cao cap AD019,249000,249000,4.3,19,98
0,0, Ao thun tanktop unisex sat nach form rong SUPER nam nu ulzzang Wind,79000,79000,4,1,
0,0,Quan The Thao Den Dang Om ONGBO98 (Ong Bo),90000,90000,0,0,
0,0,Ao so mi nam caro - KLS125,88000,88000,5,9,29
0,0,Quan jogger Kaki Linh Ran Ri Nam Nu Deu Mac Duoc DQ05,75000,75000,4.5,4,16
0,0,"Quan the thao 3 soc nam nu ( hinh that ) , quan jogger ni nam 3 soc, quan jogger thun, quan the thao nam, quan ni nam",68000,68000,0,0,
0,0,"AO KHOAC DU BOMBER,THIET KE HOA TIET SIEU NGAU,CHAT LIEU VAI THOANG MAT 1HIT1 FASHION",85000,85000,0,0,
0,0,Bo quan ao the thao nam nu in DINK,73000,73000,0,0,
0,0,Ao hoodie chat PE in hoat hinh,107900,107900,5,3,3
0,0,AO BOMBER GIO 2 LOP ,90000,90000,3,2,2
0,0,Ao Khoac Fanel Nam Nu Form Rong Unisex Do Caro,95000,95000,5,1,1
0,0,Ao Khoac Bomber Ni Chu CS Form Rong Unisex Chat Ni Ngoai Ulzzang,105000,105000,5,1,2
0,0,Ao Khoac Bomber TIKKEO 2 lop chat ni da day dan lot du cuc xin Form unisex Nam/Nu cuc dep hang cao cap,95000,95000,4,1,
0,0,Ao Thun Tay Dai Tron Dang Rong Mau Den Long Tee Black Unisex - MM,59000,59000,5,1,3
0,0,SET BO THE THAO NAM FROM RONG THOAI MAI PHONG CACH HAN QUOC,77000,77000,0,0,
0,0,"AO KHOAC NI NAM NU HINH THAT HANG BAO DEP, BAO CHAT (poles..)",115000,115000,0,0,
0,0,Ao Khoac Cardigan Nam Nu Form Rong Unisex Chat Ni Ngoai Day Dan Cuc Hot in logo khong bong troc (candles),92000,92000,0,0,
0,0,"Ao KHOAC DU 2 LOP unisex form rong cap doi ulzzang Han Quoc danh cho nam nu, Ao khoac du 2 lop mau den co non Glean local brand ONTOP JACKET cho nam nu cho cap doi,Ao khoac du unisex Glean Mark 2 local brand ONTOP",108000,108000,4,1,3
0,0,"Quan short kaki nam lung thun, tu 45kg den BIG SIZE 90kg - NH shop",69000,69000,4.5,2,5
0,0,Ao Khoac Kaki Unisex Phoi 2 Soc Tay O Tay From Rong Size Tu 45kg - 75kg,167500,167500,5,1,1
0,0,() Ao Khoac Bomber Nam Nu - Ao Khoac Unisex Gau Vai Ni Bong day Sieu Hot - AZ.STORE,169000,169000,4,1,6
0,0,"AO KHOAC KAKI Form Rong XL Tui Hop Ngang CAO CAP, Ao khoac kaki nam , ao khoac nam chat kaki 2 lop , form rong",165000,165000,4,1,
0,0,"Ao khoac kaki form rong tui hop in lung, kem anh that CAO CAP",165000,165000,5,1,
95550,49,AO HOODIE NI NGOAI NAM NU CHAT DAY DAN CUC DEP CUC NGAU,195000,99450,1,1,2
0,0,"Quan jogger tui hop chat kaki min, dep, cuc ngau",87000,87000,4,2,1
99000,50,"AO HOODIE NI NGOAI BAO DEP, CHAT (cv)",198000,99000,5,1,2
0,0,"Do bo the thao nam nu vai thun lanh mem min, Thoi Trang Phong Cach Han Quoc-Nhieu kieu lua chon, Do Bo The Thao Nam, Do Bo Mac Nha chat lieu thun cao cap mat me, tham hut mo hoi tot, Do bo nam nu mac nha dep",93000,93000,4,2,6
95200,44,"Ao Thun Cap, Ao Thun Nam Nu, Ao Thun Unisex, Ao Doi Nam Nu Chat Thun Cotton Co Dan Tot Tham Hut Mo Hoi Tot Thuong Hieu Chandi Ma ANN1",214200,119000,5,7,17
0,0,Ao khoac mang to nam tre mau moi nhat NMT21,1850000,1850000,4.3,6,13
0,0,Combo 2 Quan Dui Nam Loai 2 Soc Vai Chon Loai Dep Chat Sieu Mat Freesize Duoi 65kg,49000,49000,4.3,9,28
90000,24,"Quan tay nam ong con Amazing, dang tre om gon, nhieu mau nam tinh, chat lieu co gian, phong cach Han Quoc, tre trung, nang dong",379000,289000,4.3,7,11
0,0,"Ao Khoac Du Nam 2 Lop, Chong Nang, Di Mua, Chong gio va tia UV Su Dung 4 Mua",159000,159000,4.5,20,61
0,0,Quan dai kaki nam cong so co size lon big size tre trung Nexx & Dee 02,219000,219000,4.3,3,4
127200,44,"Quan bo nam bo chan Julido Store, xu huong moi nhat cua gioi tre mau moi BC681",286200,159000,4.5,37,63
0,0,Quan jean nam jogger cao cap vai day co dan tot mau moi nhat hien nay Phuongnamshop20 kva8,127500,127500,4,2,3
0,0,Do Bo Nam mac nha Do mac o nha nam The Thao Cotton day XOP THAI mac o nha du size toi 85kg - MINHSTORE,119000,119000,5,1,4
0,0,Ao hoddie in hinh chu Khung Long,58000,58000,4.3,12,30
0,0,"Ao thun Nam Nu Khong co NARUTO KAKASHI DUNG CHIDORI MSOP-28 mau moi cuc dep, co size be cho tre em / ao thun Anime Manga Unisex Nam Nu, ao phong thiet ke co tron basic coc tay thoang mat",39999,39999,5,1,2
0,0,HOT RE VO DICH ao phong tay lo  Luffy - Ao One Piece dep gia re thoi trang nam,128700,128700,5,1,4
0,0,Ao khoac Blazer ke nam nu City Cycle - Ao vest khoac ngoai dep phong cach Unisex Local Brand,499000,499000,5,1,2
0,0,Quan short thun nam co luoi thong hoi Phuc An 1051,109000,109000,4.8,4,31
127200,44,"Ao Thun Nam Ngan Tay Thuong Hieu Chandi, Chat Thun Cotton Xin Mau Moi NH1",286200,159000,5,9,19
0,0,AO KHOAC DU NAM NU THIET KE HOA TIET SIEU NGAU THOI TRANG KING STORE,97000,97000,4.5,2,3
100000,0,So mi nam hoa tiet soi va dai bang thoi trang,0,175000,5,1,
0,0,Quan Jeans Nam Dang Om JEAN99 (Jean),99000,99000,4,1,10
0,0,Ao So Mi Nam Co Tru Cao Cap Y Hinh,220000,220000,2.8,6,8
0,0,Quan Jeans Rach Goi Nam Dang Tre Trung RACHGOI01,159000,159000,5,2,21
0,0, Ao Khoac Du 2 Lop Chong Nang - HD100,149000,149000,3.2,5,20
100000,25,"Ao khoac Kaki Jean nam HAHAMAN cao cap 2 tui nguc, chat xin day, hang chinh hang KKJ3020",399000,299000,5,1,2
0,0,AO KHOAC DU BOMBER CAO CO BLACK MIACK,93000,93000,4,1,4
0,0,"Bo thun nam King168 , do bo nam cao cap Q02",0,150000,5,1,
0,0,"Ao khoac jean nam King168 , ao khoac bo cao cap AK16",0,250000,2,2,
0,0,"Ao khoac nam King168 , ao khoac kaki nam cao cap K099",0,149000,1.7,3,
0,0,"Quan Jean Nam Rach mau xam King168, phong cach bui bam han quoc ML0552",0,159000,4,1,
0,0,"Ao thun nam tay dai King168 , ao phong nam dai tay cao cap ATD03",0,100000,2.5,2,
0,0,Ao Khoac Kaki Nam Phoi Khoa Keo Day Dan,239000,239000,4.1,10,22
0,0,Mau ao choang cosplay Attack on titan doc dep,199000,199000,3.8,8,25
145000,38,"Ao khoac nam AK Corner vai Xi Nhat cao cap 2 lop day dan, thiet ke giau non tien loi, chong gio bui, chong nang tot",380000,235000,5,2,3
0,0,Bo Quan Ao Nam SE67,225000,225000,0,0,
60000,34,"Combo 2 quan lung mac nha, chat kate tron, mem, min, thoang mat - FORMENSHOP - FMCB2TS011",179000,119000,4.7,17,52
0,0,Ao Sweater Ni Bong Tron Du Mau ( unisex nam nu deu mac duoc),82000,82000,3.8,6,13
0,0, Ao thun tay lo cotton thoang mat gau rong (unisex nam nu deu mac duoc)gui,99000,99000,0,0,4
59000,50,Ao thun tay lo cotton thoang mat vien chu nhat (unisex nam nu deu mac duoc),118000,59000,3.3,6,9
140000,39,"Ao khoac cao cap Bomber Korea, vai Xi Nhat cao cap khong nhan, co lop hut am, thoang mat, thiet ke hop thoi trang",360000,220000,5,7,9
0,0,Quan Dui Thun Cotton Nam LYLY FASHION,99000,99000,4.5,29,79
0,0,Ao so mi nam cong so dep (soc ngang),100000,100000,3,2,3
129000,43,Ao dai tay vat bau THE 1992 Sweater basic nam,298000,169000,1,1,4
46000,22,"Ao Polo nam co be ngan tay, chat lieu cao cap, thoang mat, ben mau, thiet ke tre trung – FORMEN SHOP – FMPS054",205000,159000,4.6,5,23
81000,39,"Ao thun nam co tron tay ngan, chat thun cao cap, tre trung, nang dong – FORMEN SHOP – FMPS003",210000,129000,5,3,15
0,0,Ao Khoac Gio In Hinh 3D Hoat Tiet Nam Nu FAVITI AK97,125000,125000,5,1,1
0,0,Ao Thun Menstyle Chat Dep Phong Cach Thoi Trang Nam - MS28,104780,104780,5,1,1
0,0,Quan short thun nam lat lai Phuc An mau xam 1049,99000,99000,4.5,2,11
0,0,quan dui nam quan dui nam hoa tiet QDtron den cao cap,42000,42000,4.8,4,4
0,0,Ao thun nam unisex phong rong hoa tiet sieu hot (UX-06-28),39000,39000,4.6,14,31
0,0,AO KHOAC KAKI NAM DAY DAN DEP Y HINH,239000,239000,3.3,3,5
0,0,Ao So Mi Nam Tay Ngan Hoa Tiet The Shirts Studio Han Quoc TD42F2333,69000,69000,5,2,6
79200,44,"Ao Thun Nam Nu Dai Tay Unisex , thoi trang thu dong thuong hieu Julido Store thiet ke co tron in Nhiet khong bong troc khi giat TD01",178200,99000,4.7,49,102
200000,44,Ao khoac du form dep Lados - 2028 chat du chong truot nuoc,450000,250000,4,1,
0,0,"ao hoodie nam nu, ao hoodie nu, ao hoodie nam, ao hoodie ulzzang, ao hoodie unisex, Ao Hoodie Ni Bong Unisex Streetwear Luc Lang ( unisex nam nu deu mac duoc)",95000,95000,4.5,2,25
0,0,"Quan dai the thao nam thoi trang mau xanh, xam, den HQ5",129300,129300,4,3,
0,0,GIAM 75% Bo vest nam 6 cuc Han Quoc dep mau trang gia sieu re - DUKI STORE,699000,699000,4,1,
0,0,"Ao khoac da, mang to nam Han Quoc dang dai- vai da day dan 900gr - OMAN AD030",399000,399000,5,2,9
0,0,Ao So Mi Nam Dai Tay Phoi Tui Hop Thoi Trang Cao Cap Chat Vai Thoang Mat Cao Cap,135000,135000,4,2,5
0,0,Ao So Mi Nam Dai Tay Phoi Soc Chim Thoi Trang Mixupshop Chat Kate Lua Mem Mai Tham Hut Tot,145000,145000,5,2,4
0,0,Ao Thun Nam Co Co Tay Ngan  ,125000,125000,3.5,2,7
0,0," { HANG MOI SALE SOC } B45 Bo dui dai trung nien, Chat lieu dui tu nhien 100%",229000,229000,5,2,11
0,0,AO KHOAC DU CHONG THAM NUOC 2 LOP DA NANG SIEU  DEP,159000,159000,4.5,12,39
0,0,Ao khoac gio nam ikea sieu hot,159000,159000,4.3,25,346
0,0,Ao thun nam ngan tay hoa tiet vuong mien,77000,77000,5,1,1
0,0,(co video)Ao khoac du nam ngoai nhap tui hop phoi mau doc la hot triend 2020,159000,159000,4.1,45,111
0,0,"Ao khoac du nhe nam 2 lop di nang di mua,phoi  hai mau phong cach don gian ,lich su, tui co day keo va tui trong hot triend 2020",149000,149000,4.3,69,230
0,0,"Ao len nam co 3 phan, co lo cao cap chat len mem min kieu dang han quoc ALN0015",148000,148000,5,5,13
0,0,Quan Sot Jean Nam Tron ( Co Bigsize),69000,69000,5,3,8
0,0,Ao Hoodie Ni Bong Nam Nu Unisex Streetwear Luc Lang Moi nhat - To To Shop ,88000,88000,0,0,3
0,0,Ao Thun Nam Phan Quang Anh Dung Day Tu Chieu,60000,60000,4.5,23,44
0,0,"Quan baggy nam nu kaki unisex, quan baggy kaki nam nu",86000,86000,5,1,6
0,0,Quan dai the thao jogger nam nu chat vai umy day dan hang cao cap Q26,99000,99000,5,1,2
0,0,Quan Dai KaKi Nam Tui Hop Cao Cap Hai Trieu 020,230000,230000,4,2,5
0,0,Ao So Mi Nam XK74,201500,201500,5,1,3
0,0,"AO khoac  nhe  nam 2 lop  hoa  tiet chu  M sau lung  ,phong cach  hot trend",139000,139000,4.5,15,35
50000,32, Qua Nam Quan Dui Trang Nam Quan Dai Quan Mac He Quan dui dai nam ong con cap chun day rut,153900,103900,5,1,6
55000,7,"Quan ao giu nhiet cho nam, Bo giu am cho nam , Quan ao bo sat chong lanh co tim",750000,695000,5,2,2
0,0,QUAN KAKI NAM TUI MY VIEN DANG SUONG MAU KEM DAM DEP,150000,150000,5,1,2
0,0,Quan Dai KaKi Nam Trung Nien Hai Trieu 036,145000,145000,4,1,1
30000,40,"Quan Lot Nam 5S (5BX020) Chat Lieu Bambo Cao Cap, Mem Min Thoang Mat",75000,45000,5,9,77
0,0,Ao thun Luffy mu rom    Ao phong cotton tay ngan hoat hinh One piece dao hai tac unisex nam nu ban deu dep,39000,39000,4.2,5,24
0,0,"Quan vai nam,quan baggy ong rong kieu dang basic ma Q010",159000,159000,4.5,2,4
0,0,Quan Shorts Kaki Nam Tui Hop Phong Cach Manh Me,189000,189000,4.6,11,44
0,0,AO KHOAC DA NAM LOT LONG DAY,369000,369000,4.5,2,2
61000,38,Ao thun nam ngan tay co co kieu the thao phoi co TKAHT23 PigoFashion nhieu mau,160000,99000,5,2,9
150000,28,Quan Tay Au Nam Trung Nien Co Ly Cao Cap 9909 Viet Phap,529000,379000,5,1,1
150000,33,Ao So Mi Nam Trung Nien Tay Ngan Vat Ngang Lua Cao Cap 9501 Viet Phap,459000,309000,5,1,1
0,0,Ao Thun The Thao Nam ADIDAS - FL3886,900000,900000,4,5,7
101000,27,"Combo 2 quan short nam the thao thun lanh cao cap thoai mai, nang dong, tre trung - FORMEN SHOP - FMCB3PS094",380000,279000,4.5,31,86
30000,16,"Ao Polo nam co be ngan tay, chat lieu vai ca sau cotton cao cap, tre trung, nang dong – FORMEN SHOP – FMPS130",189000,159000,5,1,4
81000,35,"Ao Polo nam co be ngan tay, chat lieu vai ca sau cotton cao cap, tre trung, nang dong – FORMEN SHOP – FMPS106",230000,149000,5,4,11
0,0,"Quan Au Nam Cong So FAJA Cao Cap, Kieu Dang Hien Dai",95000,95000,4.1,73,450
0,0,"Ao phao nam, ao khoac phao nam big size ngoai co size chau au",899000,899000,3,1,1
0,0,Ao thun lot nam coc tay loai 1,33000,33000,0,0,
0,0,Ao Polo Nam cao cap thiet ke hoa tiet Cotton ZAKADO - ZAP06,429000,429000,5,3,4
0,0,"AO THUN NAM DAI TAY CO BE MAU MOI NHIEU MAU, 3 SIZE(PHOM 50-75KG), LOGO THEU, VAI 100% COTTON CAO CAP",289000,289000,4.3,24,43
0,0,"Zakado Outlet - Ao thun cao cap co tim, tay ngan mem mai.",180000,180000,5,4,9
0,0,"Quan Jean Nam Quan Bo Nam Rach Goi Mau Den Tron, Thoi trang Cao cap",170000,170000,0,0,8
127200,44,Quan jean nam cao cap 4 chieu co dan Julido Store - hang loai xin mau QJ8888,286200,159000,4,32,66
0,0,"[COMBO 3] Ao Thun ba lo The Thao Nam in chu LION, dang TANKTOP Thun Thai nhieu mau Cuc Dep",160000,160000,3,1,1
0,0," Quan dui dang dai Jack Lane, quan dui nam nu unisex ong rong, JACKLANE",416000,416000,5,2,2
0,0,Ao Len Nam Dai Tay Tron Basic CEFFYLO Mau Den Vai Len Am Ap,420000,420000,5,1,
0,0,"Bo Scrubs bac si phong mo, ky thuat vien, ho ly, ho sinh, dieu duong benh vien, spa mau xanh than - Nam",245000,245000,5,2,3
0,0,Ao thun chu dang rong cuc chat,74500,74500,5,1,2
0,0,AO THUN NAM DAI TAY COTTON DEP Y HINH,149000,149000,5,5,7
0,0,Ao So Mi Nu Tron Dai Tay Cao Cap,125000,125000,5,2,2
0,0,"Hop 5 Quan lot, sip dui nam thong hoi thoang mat 409 lo nho",122500,122500,1,1,3
0,0,Ao hoodie zipper unisex 2T Store HZ01 mau den,159000,159000,2,1,1
0,0,Quan Jogger nam phong cach tre trung nang dong,195000,195000,4.7,3,10
0,0,Ao thun nam tay ngan,99000,99000,4,1,1
0,0,Quan Xi Lot Nam Tam Giac Bang Nho Cotton Sieu Mong Thoang Mat SUNMEN Tu 45 den 75kg,10000,10000,4,1,3
0,0,"Ao ni Hoodie Drew House VẸT, Ao hoodie nam nu ni bong cotton",179000,179000,1,1,
64000,40,SHORT LINNER FEZZIO 100% COTTON CHINH HANG,159000,95000,5,2,9
0,0,Ao Polo Nam Trung Nien Soc Ngang Co Tui chat lieu cotton cao cap ngan JD70,159000,159000,5,1,
0,0,"Ao Thun Nam Phan Quang  anime Naruto , ao chat, di dem, di phuot bao ngau, nhin da mat",59000,59000,4.5,2,4
0,0,"Ao Polo Nam Co Co Tui Trung Nien - Tham Hut Mo Hoi, Co Gian Da Chieu",159000,159000,5,1,2
0,0,Quan Kaki Tui Hop Nam Noi Ong Co Chun Eo Chuyen Phuot,389970,389970,4.8,11,28
0,0,Ao thun nam nu cao cap vai cotton xin co dan vai mat mau hot 2021 Phuongnamshop20 m40,75900,75900,5,1,2
0,0,Quan sot nam soc thoi trang,109000,109000,5,1,9
0,0,Ao Polo nam phoi ngang PEGAS vai ca sau Cotton ️ Hang VNXK ️Ao polo nam xuat khau,159000,159000,5,1,4
0,0,"Quan jean nam LB, jean co gian mau xam tro cao nhe QJ456, phom quan Skinny Fit jean",250000,250000,4,1,1
0,0,"SET BO THUN THAI NAM THICH HOP DI DAO,DI CHOI",69000,69000,1,1,2
0,0,QUAN JEAN NAM RACH PHA CACH,180000,180000,4,3,4
0,0,BO DO NAM DAI NI COTTON DAY AM,269000,269000,4.1,9,18
115000,46,Ao khoac du Hahaman da quang 2 lop cao cap co dung AKD01004,250000,135000,5,2,2
81000,41,Ao thun nam dai tay co be Hahaman cao cap mau xanh nhat CBDT03,200000,119000,4.5,2,5
0,0,Ao khoac the thao nam thoi trang HK2,175000,175000,5,1,1
53200,26,Ao khoac nam chat du nhe lot long cuu chong nuoc cao cap reu,207200,154000,4.7,3,5
0,0,"Quan au nam Vai Tuyet Han chong nhan chat lieu sieu mat, cam ket dep nhu hinh(Mau Den)",98000,98000,2,1,6
0,0,Quan Lot Nam Formen ban nho hang dep [Chinh hang],90000,90000,5,1,
0,0,Ao hoodie ni do do Deep Red hoodie unisex,105000,105000,5,1,2
0,0,Ao thun nam POLO phoi mau vai ca sau cotton cao cap ngan tay cuc sang trong,99000,99000,5,3,3
0,0,Ao thun tre em Minecraft sieu doc | chat dep MC28 | Ao Chat Store,0,130800,5,1,
0,0,Combo 2 Quan Jean Nam Muidoi Q153 - Xanh Lam,300000,300000,4.2,37,132
0,0,(SALE) Ao thun lien quan mobi - Vahien so 7,114582,114582,1,1,2
160000,24,Ao Khoac Nam Lot Long 0777,659000,499000,1,1,
0,0,Quan short thun nam the thao tap gym - A058,160000,160000,5,2,9
0,0,Ao khoac nam da bo cao cap lot long khoa kep 2 chieu Martin - Butuni,5500000,5500000,5,1,1
181000,48,Quan dai kaki nam tui hop thoi trang cao cap Hahaman HAHA203,380000,199000,4,2,6
0,0,Quan The Duc Hoc Sinh,50700,50700,5,1,4
0,0, Ao Thun Nam Ran Ri Linh My - Ao Phong Nam cotton Quan Doi,100000,100000,3,2,4
0,0,Ao so mi Titishop SM468 tay ngan phoi soc ngang mau do,49000,49000,1,1,2
0,0,AO THUN SWE KHOI UNISEX,290000,290000,4,1,
0,0,AO KHOAC JEAN NAM CO TRU DEP DAY DAN KHONG RA MAU,229000,229000,1,1,1
0,0,"Bo 5 quan lot nam vai thun lanh cao cap, lung chu BANG LON, quan xip 5x290",160000,160000,5,1,4
0,0,Sip Dui- Quan Lot Nam Boxer Bang Lua Giam Nhiet Sieu Mong Mat K129,65000,65000,5,1,4
50000,48,"Quan short dui nam vai du, hang nhap Quang Chau",105000,55000,4,1,1
64500,50,QUAN NGU THUN NAM COTTON 4 CHIEU FEZZIO,129000,64500,5,1,2
0,0,"Ao So Mi Nam Caro Tra Sua Mau GQ03 Thoi Trang TOP FASHION TOP Cao Cap Phong Cach Han Quoc Tre Trung, Ca Tinh",125000,125000,4,1,2
0,0,Quan sot lung Nam tui hop hang ban tai xuong may,25000,25000,3.3,6,22
50000,34,"Ao so mi nam body ke caro (ke do), hang nhap Quang chau",149000,99000,5,1,1
0,0,Bo The Thao Nam Dai Tay - Bo Thu Dong Chat Lieu Ni Cao Cap Mem Min - BD05,189000,189000,3,2,9
0,0,Ao So Mi Dai Tay Han Quoc Vai Lua Chong Nhan,99000,99000,2,3,5
0,0,Quan lot nam dolex thun lanh [Anh that] [Chinh hang],14500,14500,5,1,
0,0,quan short kaki day keo cao cap,79000,79000,3.8,5,12
0,0,Ao phong unisex nam nu form rong tay lo,85204,85204,5,1,1
0,0,Ao khoac hoodie in hoa tiet sieu hot phong cach ASALA (hd-CN-1003),69000,69000,3,1,2
0,0,"Ao thun nam co tron logo dap noi vai Cotton co gian,day dan, form regular fit",159000,159000,5,1,
0,0,Ao thun unisex this is my friday form dep vai day min mat 2019T978,24900,24900,4,1,
0,0,AO HOODIES NAM NU SIEU XINH ,79000,79000,3.5,2,
0,0,SO MI NAM DUI CARO CHAT DEP CHONG NHAN,104000,104000,4,1,
0,0,AO SO MI NAM NGAN TAY DEP,200000,200000,5,2,2
0,0,AO THUN HADES Soi Singum nam nu Full tag chinh hang Logo Tay Logo Co,290000,290000,5,1,1
0,0,Do bo the thao nam cao cap vai thun lanh sieu co dan hang chuan shop Phuongnamshop20 z5,93750,93750,2,1,
0,0,"AO KHOAC DU NAM NU THIET KE MAU SAC HAI HOA,CHAT LIEU VAI THOANG MAT",99000,99000,0,0,
0,0,Ao thun Polo nam co be vai ca sau Cotton tre trung chat lieu cotton 100% phong cach hien dai,159000,159000,5,2,
0,0,Quan Dui Au Nam Cao Cap-QD41+VT,106800,106800,5,7,24
121000,40,QUAN SHORT KAKI NAM HAHAMAN TUI HOP CAO CAP QSKKH02008,300000,179000,4,1,3
0,0,Ao Khoac Ni Tron Nhieu Mau - Chat Ni Cotton day dan - Form rong phu hop khi di choi di hoc cafe,135000,135000,5,1,1
0,0,"Quan Dui Nam Mau Xam 3 Soc Den The Thao, Vai Ni Da Ca (anh that)",30000,30000,1,1,4
115000,38,Ao khoac jean nam HAHAMAN thoi trang cao cap AKJ007,300000,185000,1,1,2
0,0,"Ao thun nam Ao Thun Nam co co tay phoi caro Mau 02 Chat thun mem min, thoang mat, tham hut mo hoi tot",125000,125000,5,1,5
0,0,Quan Lot Nam Thun Lanh ,95000,95000,4.7,20,105
0,0,Quan Dui Au Nam Cao Cap-QD41+TN,141700,141700,5,1,5
0,0,BO DUI NAM QUAN DUI AO COC TAY,135370,135370,5,1,3
0,0,Quan Tay 0Ly Classic 475 Vinh Tien - ND1-C081 - Nau Nhat,475000,475000,5,1,
0,0,Combo 2 Quan Short Lung Thun Nam Thoi Trang Mau Ngau Nhien,239000,239000,5,1,4
0,0,Quan dui sip nam Nhat Huy cotton sieu mong,48000,48000,4.5,2,
0,0,ao ba lo nam ao lot nam chat cotton mong sieu mat hang Ha Noi Viet Nam,16188,16188,5,1,27
0,0,"Ao so mi nam co Tru Mau Xam Tieu Nhat, AO SO MI CO TAU Mau Xam tieu,Ao So Mi Dui Xuoc Co Tau Hot Nhat",103000,103000,5,2,2
0,0,AO KHOAC DU DAY NAM NU CAO CAP-IN HOA TIET DAU TRAU HOT 2021,389000,389000,5,1,2
0,0,{FREE SHIP} AO SO MI /AO SO MI NAM TAY DAI VAI DUI NHAT PHONG CACH MOI,119000,119000,0,0,
0,0,QUAN AU VULCANO 1014,478400,478400,5,1,
0,0,"Ao Polo Nam Trung Nien ,cotton xuat xin  cao cap from chuan, thiet ke phong cach sang trong JULIDO50",159000,159000,5,1,4
0,0,Quan jean nam mau den wash bac dui dep chat,128000,128000,5,1,
0,0,Set bo do thun nam the thao cuc chat phong cach cho mua he THOI TRANG MOI KINGSHOP79,79000,79000,4.5,4,5
0,0,AO KHOAC JEAN NAM SIEU HOT VAI SIEU DAY PHUONGNAMSHOP20 KK5,165000,165000,5,2,2
0,0,Ao Lot Nam Dong Xuan Xuat Nhat Coc Tay Mau Trang,69000,69000,3.5,8,42
0,0,Ao khoac du dau soi form rong nam nu vo tu dien nu,72000,72000,1,1,8
0,0,Ao So Mi Nam Dai Tay Co Ve In Hinh Meo Hoa Tiet Chu SOMEONE Thoi Trang Zenkonu SO MI NAM 1000023,89000,89000,1,1,2
0,0,Bo Quan Ao Nam Ao Tron Co Tron Vat Ao Duoi Tom Quan Short Ca Tinh Thoi Trang Zenkonu TOP NAM 1000145 + SHORT NAM 1000010,79000,79000,4.7,3,9
0,0,Ao Polo Co So Mi Nam Thun Tron Co Ve Co Hai Mau Trang Den Ngan Tay Hot Trend 2021 Thoi Trang Zenkonu SO MI NAM 1000018V3,69000,69000,0,0,
0,0,Bo Quan Ao Nam Ao Hoodie Quan Jogger Bo Gau Phong Cach The Thao Thoi Trang Zenkonu TOP NAM 1000124 + QUAN NAM 1000069,109000,109000,1,1,7
0,0,Ao Thun Nam Dai Tay Co Tron Hoa Tiet Nguoi Hoat Hinh Chu X Phong Cach Tre Trung Thoi Trang Zenkonu TOP NAM 1000143V1,62100,62100,4,1,3
0,0,Bo Quan Ao Nam Ao So Mi Vet Son Quan Short Soc In Chu Ulzzang Thoi Trang Zenkonu SHORT NAM 1000029 + SO MI NAM 1000029,99000,99000,5,2,8
0,0,QUAN NI NAM THOI TRANG HAN QUOC FORM RONG SIEU DEP,97000,97000,5,1,1
0,0,AO THUN NAM CO TRU FOMR BODY theu 1970,75000,75000,4,1,1
0,0,"Quan lot nam Tam giac thun lanh cao cap, Quan sip nam tam giac chat thun lanh Cao cap dan 4 chieu (che ten)- MinhStore",95000,95000,5,1,9
0,0,Ao so mi cap nam Nu Cap Doi couple,107000,107000,4.8,4,34
0,0,[MAU MOI] Ao So Mi Nam Tron LV523,99000,99000,5,1,4
0,0,SET BO THU DONG DAI CUC CHAT,135000,135000,1,1,2
127200,44,"Ao Thun Nam Ngan Tay Thuong Hieu Chandi, Chat Thun Cotton Xin Mau Moi NH7",286200,159000,4.8,9,25
0,0,Bo quan ao the thao nam nu in USA,69000,69000,5,2,8
0,0,BO QUAN AO THU DONG,279000,279000,4.1,12,27
0,0,"Set BO NGAN Mac Nha Chat Thun Lanh Chu A ️ CO ANH CHUP THAT ️ Quan Ao 3D Nam The Thao , DO BO MAC NHA THE THAO NAM LOANG 2 MAU CA TINH - JINS STORE",98000,98000,3,1,6
0,0,AO SO MI NAM LUA KATE IN 5D CHM CONG CAO CAP(M2),99000,99000,3.8,20,106
50000,9,"Ao khoac mang to da nam dang dai tui cheo, thoi trang tre, phong cach lich lam",540000,490000,4.3,4,5
0,0,"AO KHOAC KAKI NAM NU FORM RONG THOI TRANG HAN QUOC , CO TUI HOP TRUM MU CUC DEP THOI TRANG 2021",120000,120000,5,1,6
0,0,AO KHOAC NAM NU VAI NI FORM RONG CHILI CLUB TP,128240,128240,1,1,1
0,0,Ao Hoodie Ni Lot Bong FUNNY Unisex 1hit_unisex,169000,169000,5,1,
0,0,QUAN NI NAM DAI PC HAN QUOC DOC DAO SIEU HOT CHO CAC BAN,65000,65000,5,2,2
0,0,QUAN SHORT JEAN NAM MAU SIEU HOT VAI SIEU DEP KK29,113000,113000,5,1,4
0,0,Ao Khoac Nhe Nam Nu Thu Dong 2 Lop Co Ta In Chu CREATE-213 hOT Triend,139000,139000,3.8,8,32
0,0,Ao Thun Nam Lon Tuoi Co Tui️ Hang VNXK ️Ao Thun Nam Co Tui Trung Nien ( chat lieu 100% cotton mem min) Ao thun co co,159000,159000,5,2,6
171000,30,"Ao so mi tay dai nam AKUBA form regular, so mi cotton kaki, da qua xu ly vai, mem min khong bi co rut 02B456",569000,398000,5,1,2
0,0,Quan CUC LUNG Unisex N7 nam nu ni da ca cao cap thu dong basic pant thoi trang phong cach Han quoc Ulzzang,189000,189000,4.5,2,3
70000,39,"Ao Khoac Du Nam Chong Nang, Truoc Nuoc Cao Cap - PS21 ",179000,109000,4.1,14,56
0,0,Ao Hoodie GenlaL - Nam Nu Unisex Ulzzang Han Quoc - Vai Ni Bong Form Rong Khong Xu Long,135000,135000,4,2,11
0,0,Ao so mi ngan tay viet tien mau xanh vo dau,300000,300000,5,2,5
0,0,Ao hoodie form rong phong cach Han Quoc nang dong cho cap doi ( Ma M3),145000,145000,4.3,3,13
0,0,Quan Khaki tron Xam Nhat Nam Cao Cap Cong So (tui cheo) CEFFYLO Dang Basic Phong Cach Tre Trung,370000,370000,3,1,
0,0,Ao so mi nam ngan tay May 10,199000,199000,5,1,8
0,0,AO SWEATER 4 MAU NI NGOAI FORM RONG OVERSIZE (Unisex nam nu deu mac duoc),94900,94900,5,2,4
0,0, Ao khoac dang vest co be nam trung nien QA013,560000,560000,4,2,6
0,0,Ao Khoac Hoodie Among US Kieu Dang Thoi Trang Vai Ni Day Mau Moi,199000,199000,3.5,2,6
0,0,Ao Thun Nam Co Tron WinBeen Form Rong Streetwear Clothing Ao Phong Unisex Basic Cotton Oversize Gia Re In Phi Hanh Gia NASA,99000,99000,4,1,6
0,0,Ao khoac Bomber Teelab From Hell AK022,300000,300000,4,2,5
0,0,Ao So Mi Nam Trang Tron TRANGBE99 (Trang Be) - L,99000,99000,0,0,72
0,0,Ao So Mi Nam Trang Tron,74000,74000,3.4,7,184
0,0,Ao So Mi Nam Dai Tay SM004,68000,68000,0,0,5
0,0,Ao khoac bong chay nam Samexoy ni hai mau den trang,95000,95000,5,1,1
0,0,AO KHOAC DU NAM CHONG NANG TRUOT NUOC THIET KE TINH TE HOA NAM THAN HANG MOI,95000,95000,0,0,
0,0,"Ao Khoac Kaki Nam Nu Han Quoc Form Rong Vai Jean Kaki, Chong Nang, Chong Nhan, De Giat Sach, Nhanh Kho, Danh Cho Ban Tre Nang Dong, Nhieu Mau Phu Hop Voi Moi Truong Cong So, Di Choi, Cafe Hoac Di Dao. ",148000,148000,0,0,1
0,0,"Quan lot dui nam cotton, quan sip nam co gian, mat mau dep",21000,21000,5,1,12
0,0,Quan Jean Nam Dep ️️ Quan Bo Nam Rach Goi Chat Lieu Denim Cao Cap Thoi Trang Chuan Hang Shop To To Shop -QJN52,169000,169000,5,1,1
0,0,Bo 4 quan lot nam dui thong hoi cao cap,135000,135000,3,1,4
0,0,Ao so mi co tru cao cap phong cach Han Quoc,99000,99000,5,1,3
0,0,"Ao thun polo nam soc ngang , chat dep , form thoai mai Lados - 9061 mat min",179000,179000,5,1,1
0,0,Ao Phao 2 Mat Long Vu va Gio Sieu Am,188000,188000,5,1,4
0,0,Quan Jogger Kaki Nam Cao Cap Chat Mat - T02,87000,87000,4,1,1
0,0,Ao Hoodie Nam Nu| Ni Cotton Trang Tron Dang Xuong  | Du Size S M L XL Cao Cap,85000,85000,3.9,28,75
0,0,"QUAN JEAN NAM MAU DEN, CHAT VAI CO DANG QJNDCD01",165000,165000,4.2,10,38
93000,40,"Combo 3 Quan sip nam thong hoi, quan lot nam chat cotton thun lanh min mat - RQ204",232000,139000,5,2,5
81000,32,Ao khoac du nam 2 lop 2 mat chong nuoc cao cap KHAVIMAN KD219 (Do),250000,169000,4,1,1
0,0,Quan giu nhiet nam mac ben trong khong lo ra ngoai- Quan tat nam  lot ni co gian khong gioi han,115000,115000,2,1,5
0,0,Ao thun nam ngan tay polo co be,99000,99000,3.5,48,1035
0,0,Quan Short Nam The Thao Cao Cap - Combo 2 quan mau trang va den,199000,199000,3.9,17,44
0,0,AO THUN NAM CA SAU CO BE MAU MOI CAO CAP,148000,148000,3,2,2
0,0,Ao Khoac Nam Kaki Phoi Non Phong Cach Han Quoc Cao Cap AK38,238000,238000,4,1,2
0,0,Quan Tay Nam Den Cong So DEN02,93000,93000,3.8,15,51
90000,31,Ao so mi nam ngan tay hoa tiet Lados - 8060 tre trung thoai mai,289000,199000,2,1,1
0,0,"Ao hoodie unisex ni bong gia re,free size den 67kg",80000,80000,5,1,8
21250,25,Quan lot boxer nam Khatoco Q5M085R0-VNMA010-2101-B,85000,63750,4.5,4,19
0,0,Ao phao tho style Nam,380000,380000,4.3,8,16
0,0,Combo 2 Quan Lot Dui Narsis F6031,200000,200000,5,1,9
0,0,Bo Quan Ao Nam Thu Dong - E5024,695000,695000,4,2,6
0,0,"Do bo Pijama-Do ngu nam cao cap phong cach Han Quoc, chat COTTON 100 day dan & thoang khi (709)",420000,420000,5,3,11
0,0,Ao so mi nam viet tien ngan tay 0370,379000,379000,5,1,1
0,0,Ao Hoodie Teelab Colorful Day HD043,500000,500000,5,1,2
37000,45,"Combo 2 quan lot nam lung Han Quoc cotton 4 chieu cao cap , lung cao,dan hoi tot, quan sip nam thuong hieu CITYMEN ( Giao mau ngau nhien )",83000,46000,4,1,13
0,0,Ao so mi nam dai tay mau vang nhat,149000,149000,4.5,18,92
0,0,Ao Thun Tay Lo SWE SMOKE TEE Unisex G-A73,101828,101828,5,2,2
477000,50,Quan Boi Nam Speedo Tech Panel Aquashort - 8-04510F317,955000,478000,5,2,6
0,0,"Quan Au Nam Cong So BLENTINO DD29593-5 Co Gian Da Chieu, Thoai Mai Khi Dung Ngoi, Chong Nhan",485000,485000,3.3,3,4
0,0,Ao so mi ngan tay nam nu co vest tron trang va den cao cap,129000,129000,4.7,7,11
0,0,Ao Thun Unisex Nam Nu Form Rong SDVN Future,150000,150000,5,1,
0,0,Quan short kaki nam lung thun vai co gian mau linh cotton mem mat,119000,119000,3.5,4,9
0,0,Ao so mi nam dai tay chat vai cotton day mem min co gian tot kieu dang slimfit mac vua van BAO DEP co size tu 45kg-85kg,69000,69000,3.6,14,35
0,0,ao so mi tay ngan nam caro cao cap 100% rat min cuc mat loai ao so mi ngan tay caro vat bau,149000,149000,4,6,13
0,0,Ao thun nam tay ngan trung nien vai cotton  day mem mat loai ao thun nam co co co tui ,98000,98000,4,4,18
0,0,Ao so mi nam co tru dai tay,149000,149000,5,3,21
297000,50,Quan jean nam GUMAC QJNB6120 dai co ban lich lam,595000,298000,5,11,21
240000,48,"Ao Thun Nam Polo Ngan Tay Co Be 5APCT018 Chinh Hang BILUXURY ,Chat Vai Pecool, Spandex  Cao Cap, Kieu Dang Body Fit Lich Lam, Co Gian 4 Chieu, Chong Nhan,Thoang Mat",499000,259000,5,1,4
0,0,Ao so mi nam ngan tay vai khong nhan,98000,98000,4.5,4,5
0,0,Ao so mi ngan tay nam hoa tiet hoa la vai LANH 2 da dep mac mat khong ra mau chuan form trung nien,99000,99000,5,1,1
5000,7,Quan Lot Nam Tam Giac Cap 1cm Bamboo Mix Mau Thuong Hieu MRM Manlywear,75000,70000,5,5,14
66000,40,"Combo 3 Quan Lot Nam, Sip Dui Nam Thong Hoi Cao Cap Zbra - ZQN09 (Mau Ngau Nhien)",165000,99000,4,4,23
0,0,Ao ni hoodie nam nu in chu Fans kieu dang nang dong hiphop - AO TOP NAM 90000175,54500,54500,5,1,2
0,0,️️ Ao thun nam tay ngan co tim vai cotton mem min Nhieu mau dang body thoi trang,117000,117000,5,1,3
0,0,Áo Thun Unisex Nam Nũ Form Rọng SDVN Freedom Brave,150000,150000,5,1,3
0,0,Blentino quan tay nam regular rqd02-2,595000,595000,4.2,5,10
0,0,"Ao hoodie ni nam thoi trang co mu phoi chu tre trung, mau sac trang nha hien dai STYLE MARVEN - AO TOP NAM 90000189",79000,79000,4,1,1
0,0,Ao Thun Hoat Hinh 7 Vien Ngoc Rong Songoku MS13 cuc chat,39000,39000,5,1,5
0,0,Ao thun nam ngan tay co tron tron mau Biluxury 4APKB003TRK,235000,235000,5,1,1
0,0,Quan jogger the thao bo ong nhan chu o suon noi bat thoi trang nam - JOGGER NAM 9000070,79000,79000,5,2,3
0,0,"Do bo PIJAMA Nam dai tay hoa tiet soc Caro, chat Cotton 100%, hang cao cap style Han Quoc thoi thuong",420000,420000,4.6,11,36
159000,53,Quan Dui Nam Kaki VICERO 6 Mau Tre Trung Phong Cach Han Quoc,298000,139000,5,1,5
150000,50,Ao Phong Nam Polo Co Co Tay Ngan Tron Mua He 6 Mau BATINO,300000,150000,5,1,
600000,46,AO THUN NAM TAY DAI LEVI'S LS REGULAR 85648-0000,1299000,699000,5,1,1
0,0,"Quan lot nam dui chat lieu mong nhe, co gian thoai mai chinh hang Santino ",105000,105000,5,6,16
0,0,Blentino ao so mi nam ke coc tay BCV16,425000,425000,5,1,4
209000,50,Bo Ni Nam Thoi Trang Nam Nang Dong Thuong Hieu VICERO,418000,209000,4.8,24,55
119000,50,Quan Short Nam The Thao Thun Ni Thoi Trang Cao Cap ZERO,238000,119000,3.8,8,16
400000,50,Quan ngan nam Ellesse Bossini Fleece - 614735,800000,400000,5,1,1
0,0,Ao Thun Co Tim Basic Nam Couple TX MTS 1095,159000,159000,5,2,6
0,0,Blentino ao so mi cotton ngan tay ke soc BCV18(2),425000,425000,4.5,2,5
0,0,Ao so mi nam dai tay tron mau khong tui Biluxury 4SMDB120TRK,439000,439000,4,3,4
0,0,Combo 4 quan lot nam tam giac thong hoi cao cap kieu moi,54000,54000,4.2,5,10
0,0,Ao thun Teelab Basic - Iconic Detail TS097,195000,195000,5,2,4
165000,50,Combo 3 Quan Sip Nam Co Gian Khong Duong May Cao Cap VICERO,330000,165000,4.8,5,15
0,0,ao so mi nam tay ngan trung nien vai lanh 2 da cuc mat hoa tiet hoa la ,99000,99000,4.7,6,10
169000,50,Quan Short Nam Kaki Tui Hop 5 Mau VICERO Premium,338000,169000,4.8,5,23
0,0,Quan Jean Nam Slimfit S6097,99000,99000,5,1,8
81000,41,Ao so mi nam caro cao cap ngan tay Hahaman HM23 nhieu mau,200000,119000,5,8,22
23000,23,ao so mi nam trung nien tay dai form rong co tui cao cap vai cotton sieu min mat loai ao dai tay so mi mau tron trang,99000,76000,5,5,19
115000,30,Combo 4 Quan Sip Dui Nam Quan Lot Nam Boxer Soi Cotton Cao Cap MRM FASHION Mix 3 Mau TANG Doi Tat Nam Cao Cap,380000,265000,4.6,17,48
112000,36,Ao Phong T - Top Nam Jockey Thun Cotton Compact In Haft Boy Cao Cap - J7339,310000,198000,5,2,16
159600,40,Ao so mi Slim Fit Shirt Blamor form om chat lieu lua cao cap hang vnxk_ASM064,399000,239400,4.8,5,9
0,0,Ao thun nam the thao thun lanh co dan 4 chieu loai ao thun tap gym choi the thao TTT02,59000,59000,4,1,4
0,0,Ao ni nam hoodie co mu STYLE MARVEN dai tay phoi chu tre trung thoi trang - AO TOP NAM 90000191,79000,79000,4,1,2
148000,30,Ao thun the thao nam New Balance - MT03917TGD,495000,347000,5,1,3
0,0,"Ao thun POLO nam ngan tay co be Santino chat lieu the thao co dan, dang om nang dong TSP365B868",365000,365000,4.5,2,2
0,0,Ao Thun Nam Loai Soc Co Vai Cotton Pha Thun Day Hut Mo Hoi Tot,99000,99000,4.8,4,12
0,0,Quan kaki trung nien cao cap vai chon loc CUC TOT mem min co gian tot khong bi nhan khong phai mau mac de chiu thoang mat co nhieu size 45kg-85kg,199000,199000,5,5,5
0,0,"BO QUAN AO THE THAO , bo quan ao nam ,BO DO NAM CHAT THUN LANH MAU DEN , DO , TRANG",78000,78000,4.5,8,30
176000,41,"Quan jogger nam tui hop chat kaki cotton mem min, phong cach duong pho R3",425000,249000,4.8,10,21
155000,34,Quan Short Nam Tron Thoi Trang AKUBA Form Skinny | 01D1958,459000,304000,5,1,21
144000,44,Ao khoac nam chat kaki 2 lop xin xo Julido Store mau moi theo xu huong thoi trang Trend MQ01,324000,180000,4,31,71
0,0,[ Anh That ] Ao khoac bomber du chat du gio 2 lop nam nu cap doi mac - Form Unisex nam phoi tay da - Hien Linh Shop,94000,94000,1,1,3
0,0,Ao thun nam co be tre trung nang dong,84000,84000,4.7,9,35
0,0,Quan lot nam Tam giac chat thun mem LADOS - 4113,38000,38000,5,3,22
190000,48,"Ao Thun Nam Polo Ngan Tay Co Be Chinh Hang Biman by Biluxury (5APCB001), Chat lieu vai Cotton Cao Cap Kieu Dang Body Fit Lich Lam, Tre Trung, Nang Dong",399000,209000,4,7,14
0,0,AO SO MI NAM LUA QUANG CHAU CAO CAP- HANG MOI SIEU DINH CHO CAC  CHANG DEP TRAI,99000,99000,3.8,5,36
0,0,AO KHOAC NAM LOT LONG CUU SIEU PHAM,160000,160000,4.5,6,12
0,0,Quan jogger nam ke soc ban to kieu dang the thao bo gau nang dong - JOGGER NAM 9000073,79000,79000,5,1,3
0,0,Ao thun nam nu form rong in hinh cuc cute ,74000,74000,4.5,2,4
0,0,Quan jogger nam nu ong rong co bo ACOVER ulzzang (ANH THAT),49000,49000,1,2,6
0,0,Ao sat nach Tank Top ao la ao ba lo nam cotton 100% cuc dep va tham hut,45000,45000,4,2,22
178000,30,Ao khoac jeans nam GUMAC AJNB838 co ban ,595000,417000,3.8,4,7
0,0,Ao Thun Nam Hoa Cuc,38000,38000,4.2,6,23
239000,44,Khoac long cuu THE 1992 Jacket nam vai gio chong nuoc,538000,299000,5,1,4
98000,35,Ao thun nam GUMAC ATNB883 in hinh ,280000,182000,5,1,4
0,0,QUAN SOT NAM KAKI KHOA KEO NHIEU MAU,49000,49000,4.1,37,139
0,0,Ao len nam loai day BS35 - BS35,350000,350000,5,3,6
0,0,Ao Khoac Ni Nam Day Dan Dep Y Hinh,200000,200000,4.2,5,25
0,0,Ao thun polo nam co co be phoi soc ngang caro vai ca sau cao cap ND08,149000,149000,4.6,10,24
0,0,Quan lot nam don mong thoang mat - Hunk PeachBoy,169000,169000,4.5,34,113
0,0,"Quan Short Jean Nam Ngan , Quan Bo Lung Nam Co Gian Sieu Chat OBOK Fashion QSN097",149000,149000,4.3,7,18
310000,67,Ao So Mi Hoa Tiet Nam Chat Lieu Lua Nen Cao Cap,460000,150000,4.7,3,4
0,0,"Quan jean nam chat lieu bo cao cap, co gian , phong cach tre trung ms82",137000,137000,3.9,9,22
26000,23,Ao Thun Nam Co Co Tim Tay Ngan Thun Cotton 4 Chieu Form Body Thoi Trang Han Quoc Cao Cap AT10 ,115000,89000,5,1,9
0,0,"AO THUN NAM TAY LO FORM RONG,4 MAU SAC CHON LUA THOI TRANG KING STORE",55000,55000,1,5,12
0,0,Ao thun tron ️️ nam form rong phong cach han quoc vai poly cotton min MAU XAM aothunphong,13525,13525,0,0,
0,0,"AO THUN NAM TAY LO FROM RONG,THIET KE HOA TIET SIEU NGAU MAU MOI NHAT HIEN NAY",55000,55000,3,1,6
84000,20,OWEN - Ao so mi trang dai tay Owen chat soi sieu mem min (Regularfit / Slimfit),420000,336000,4.7,3,7
28000,10,Ao Khoac Ni Hoodie Nam Nu BA7 2 Lop Day Dan Cotton Phong Cach Han Quoc Free Size Duoi 70kg KNN35,280000,252000,3.5,4,4
0,0,Ao thun ba lo Titishop AT368 mau xam in chu,19000,19000,4.3,3,17
0,0,quan kaki ong rong nam trung nien vai cotton day dep CHAC CHAN HAI LONG may boi Thai Khang,119000,119000,4.6,15,46
0,0,"Ao so mi dui nam co tru tay ngan 3 khuy nguc ArcticHunter, thoi trang tre, thuong hieu chinh hang",169000,169000,3,2,6
141000,49,"Ao Khoac Nhung Gan Tam Bomber Jackets Theu Logo G.O.N.Z Cuc Bam Unisex Nam Nu Form Rong Ulzzang, Ao Khoac Nhung Tam Theu Chu G, Ao BomBer Bong Chay Nam Nu Phong Cach Han Quoc",290000,149000,4.7,3,5
149500,50,Ao Thun Phong Nam Tay Ngan Co Tron Unisex Phom Rong Oversized ALONE BOY 100% Cotton Cao Cap TUTO5 AT1006,299000,149500,5,71,380
61000,38,Ao So Mi Dui Nam Ngan Tay Chat Dui Linen Cao Cap Kieu Dang Tre Trung,160000,99000,5,2,27
136000,22,Quan Tay Nam Cong So Thanh Lich AKUBA | 02P001,609000,473000,5,4,12
114000,31,Quan Short Tay Nam Cao Cap Akuba | 01HW119,369000,255000,5,3,5
140000,28,Ao So Mi Tay Ngan Nam Tron Cao Cap AKUBA | 02BW056,499000,359000,5,2,2
0,0,Hop 4 Quan Sip Nam Thong Hoi Cao Cap Sieu Hot Hit,78000,78000,3.7,7,12
0,0, COMBO 3 QUAN SIP NAM DUC SU LUA CAO CAP MAC NHU KHONG MAC,101400,101400,4.6,31,81
149000,63,Quan Short Nam The Thao Thun Ni Thoi Trang Cao Cap ZERO,238000,89000,4.5,32,104
61000,27,Ao thun nam co be Pigofashion chuan moi phong cach AB19 (chon mau),230000,169000,3.9,85,1412
0,0,Ao Thun Unisex Bad Habits SAMPLE 100% Cotton - Local Brand Chinh Hang,350000,350000,4.7,3,8
0,0,"Ao thun nam nu , ao thun unisex tay lo da quang ,Ao thun namnu form rong tay lo phat sang  , ao thun nam . ao thun nu , ao thun form rong phat sang",87000,87000,4.7,3,2
56000,29,[FREEMAN] Combo 5 quan lot nam 6034,195000,139000,4.1,26,87
36000,23,"Ao ba lo nam, ao sat nach nam,soi cotton cao cap mem min, tham hut mo hoi, sieu thoang mat, co gian 4 chieu Mrm Manlywear",155000,119000,4.7,62,170
0,0,Ao So Mi Nam 3D Hoa Tiet Sang Trong Lich Lam,139000,139000,3.3,3,9
80000,44,"Ao thun nam co tron tay dai tre trung, chat lieu cotton cao cap mau THUU1",180000,100000,4.5,2,2
0,0,Quan jean nam den tuyen rach goi - B00,119000,119000,4.3,56,179
0,0,Ao tank-top nam Aristino ATT004S1 regular fit suong nhe thoai mai,344500,344500,5,1,1
0,0,quan jean nam den rach goi,179000,179000,4.5,5,14
76000,15,Combo 5 quan lot nam thun boxer Espresso iBasic PANM103,495000,419000,5,2,7
58000,20,Combo 3 quan lot nam cotton iBasic PANM011,297000,239000,5,7,15
0,0,Quan Short Nam Thun Cao Cap Mau Den Thoi Trang - TC04053,169000,169000,4.5,2,7
0,0,QUAN SHORT THUN NAM NI CAO CAP DAY DAN,159000,159000,5,1,7
0,0,Quan jean dai nam rach - B963,119000,119000,3.8,5,52
0,0,QUAN JOGGER KAKI NAM TUI HOP PHOI DAY KHOA GAI,79000,79000,1,1,1
0,0,"Quan Jogger kaki Nam Quan jogger cho nam gioi Quan jean om vua van Quan jean skinny jean dan ong tre trung va lich lam thich hop cho cac ban nam di da ngoai, du lich, di phuot",159000,159000,3.3,4,9
0,0,QUAN SHORT KAKI NAM TUI HOP CA TINH,209000,209000,4.3,3,23
0,0,Quan Jean Nam Trung Nien Ong Suong TH011,117000,117000,0,0,1
0,0,"AO KHOAC KAKI NAM CUC CHAT PHONG CACH , SIEU XIN , CHAT , NGAU CHO ANH EM THOI TRANG MOI KINGSHOP79",199000,199000,3.3,3,4
127200,44,Quan jean nam dep dan dau xu huong Julido Store mau moi QJ0510 phong cach tre trung han quoc,286200,159000,4.8,19,36
0,0,Ao Khoac Nhung Gan Tam Bomber Jackets Theu Logo G.O.N.Z Cuc Bam Unisex Nam Nu Form Rong Ulzzang,137000,137000,2,2,7
0,0,Combo 3 quan lot dui nam xuat Nhat thong hoi - Dong goi ngau nhien khong hop,52000,52000,4,2,5
0,0,"Y301_Jean nam, quan jean nam, bo nam dep, phong cach dang jogger_HEM 1994",299000,299000,5,4,6
0,0,"Ao Thun Nam Dai Tay Unisex, ao thu dong tron tay dai co tron basic",69000,69000,4,1,
0,0,"Quan short nam loai cao cap, Quan sooc nam QSN006",89000,89000,4.7,3,27
0,0,Quan Short Bo Nam Cao Cap - Sot Jean Co Gian Mau Moi Hang VNXK -QSJN02-Ma 219,139000,139000,4.7,3,5
56000,23,"Combo 5 Quan lot nam Freeman chat lieu cotton thoang mat, gia thanh re, co gian 2 chieu, giao mau ngau nhien BO303",245000,189000,3.3,8,17
0,0,Quan dui nam the thao vai gio chun tron mat co gian 4 chieu,100000,100000,3,2,20
0,0,"Quan the thao nam,quan thu dong nam chat umi cao cap",150000,150000,2.3,3,4
0,0,Quan kaki Han Quoc - VNXK,150000,150000,4,1,1
0,0,Quan lót nam kiẻu sip tam giac Voga Hang Ngay vai thun cotton,79000,79000,4.6,24,110
192600,45,Quan tay nam Khatoco khong ply ong dung Q1M428R0-CNMA001-2004-0,428000,235400,4.6,53,123
70000,50,Combo 2 Quan Lot Nam Narsis NMB1079,140000,70000,4.3,4,31
20000,20,Ao Nam Narsis D0014 mau trang ,100000,80000,4.5,2,5
71000,20,Ao Nam Thu Dong NARSIS D7067,355000,284000,5,2,6
99000,20,Bo Quan Ao Nam Thu Dong - E7025,495000,396000,3.4,5,11
0,0,Quan short jean nam quan sot dui lung ngo theu hinh tre trung ca tinh ,129000,129000,5,2,2
35000,5,Ao Hoodie Ni Mu Unisex BOO Dang Oversized Chat Ni Cao Cap In Graphic EST.03 Phong Cach Basic,699000,664000,5,1,1
0,0,Ao Khoac Varsity Jacket N7 STUDIO bomber bong chay basic nam nu form rong Local Brand,350000,350000,3.9,7,12
68757,41, Ao Thun Nam Tay Dai Co lo,167700,98943,4,2,4
69290,41,Ao thun ngan tay khong co ️Ao thun Stee co tau tim basic ️ ️ chat vai cotton chat min tot,169000,99710,4,1,3
74620,41,ao thun tay lo nam nu form rong off white phan quang mau den Ngau Store,182000,107380,4,1,2
55692,39,Ao thun unisex nam nu tay lo SNOW mau xanh Trum Unisex unisex,142800,87108,5,1,1
0,0,"Quan kaki nam slimfit pants, lung thun, chat vai mem min, ong suong (sz: M - XXL) MK Clever - QKX06",195000,195000,4.6,5,10
102090,41,Ao Thun Unisex Hong Kong Kem anh That  The Ngau Style TNS80,249000,146910,5,1,3
73308,41,Ao Thun Phan Quang Doi canh 7 mau Cotton 100% Form Rong Unisex Nam Nu Re Dep Trum Unisex,178800,105492,4,1,2
59040,41,Ao thun Stee nam tay lo unisex form rong overtee Hoa Hong Rose chat vai cotton xin Trumunisex,144000,84960,4,2,3
72900,45,Ao thun unisex ao phong nam rong 365 kem ao that vai cotton den trang Trum Unisex Phillipstore,162000,89100,5,1,1
195000,39,Ao thun nam nu unisex edition edition In Black Trum Unisex aothununisex,500000,305000,5,1,2
73710,39,"Ao thun Tay lo Nam Nu Form Rong Unisex Thien hac mau den size M,L,XL Trum Unisex",189000,115290,3.7,26,88
65340,45,Ao thun nam tay lo form rong TROUBLE CHILD vai cotton trumunisex thengaustyle,145200,79860,5,1,7
156000,39,Ao thun Stee Unisex ETERNITY doc la Ao thun nam tay lo mau den trang vang aothununisex,400000,244000,5,1,2
97110,39,Ao thun Tay lo Nam Nu Form Rong In decal N.A.R.E.Y mau den Trum Unisex vai cotton thich hop di choi,249000,151890,4.8,5,6
0,0,Quan lot nam - Quan sip nam cao cap - Quan sip dui nam - Quan sip boxer nam Malefix Ryan 07016 phoi vien chi ,169000,169000,4.2,5,7
56000,10,OWEN - Ao so mi coc tay soi Tre BA22557NT ,560000,504000,5,1,2
9790,11,Quan lot nam Relax RLU024 dang Brief,89000,79210,4.8,25,101
0,0,Ao Thun Nam In Hinh YouTube Everest AokNAM396 (Xanh),195000,195000,4.7,12,102
0,0,"Quan lot nam boxer thun lanh cap tron,sip dui nam luoi thoang mat,co dan 4 chieu",120000,120000,5,1,20
0,0,QUAN KAKI NAM,206700,206700,4,1,4
71000,36,Ao Chong Nang Nam KOJIBA Chat Lieu KaKi,200000,129000,4.1,76,614
238000,23,"Ao khoac Blazer nam cong so sang trong AKUBA hoa tiet ke soc, vai flannel mem mai, mac thoai mai 01K3004",1039000,801000,4.5,2,7
0,0,"Quan Tay Nam Oscar Regular Fit OCMPKRF007 - Quan Au nam cong so dang dung giu form, mem min, thoang mat, chong nhan, tham hut hieu qua",1290000,1290000,4,1,1
0,0,"( Sale 30%)Quan tay nam mau den mix kep vuong phom han chuan, chat vai cheo cao cap dang om body.quan tay re, ben",299000,299000,5,1,2
0,0,quan dai tay caro thoi trang,99000,99000,5,3,8
0,0,Quan tho dui lung hoa tiet danh cho nam phong cach Nhat,189000,189000,3.7,3,12
0,0,Ao khoac Teeworld Basic Hoodie Nam Nu Unisex,198000,198000,1,1,4
0,0,"Ao Dui Co Tau Coc Tay Nam, Tui Nguc Sang Trong Lich Su",129000,129000,4.1,21,53
0,0,Quan Dui Nam Chat Vai Thun Cao Cap Form Rong Co Dan 4 Chieu Thoi Trang He San Pham Cao Cap Big Sport,149000,149000,5,32,87
0,0,Ao khoac Bomber The Bad God Embellished,675000,675000,3.7,6,11
0,0,bo quan ao dui nam,169000,169000,4.7,7,23
0,0,Bo 5 Quan Lot Nam Nhat Thong Hoi Cao Cap (Giao Nhieu Mau) MS68,84000,84000,3,2,7
11250,15,Quan lot nam Khatoco Q4M075R0-VNMA017-2112-T,75000,63750,5,6,9
61000,44,"Ao chong nang tui cuon Nam - chong nang tot, thong hoi thoang mat",140000,79000,2,1,3
0,0,"Quan short jean nam, quan dui nam chat lieu bo ( jean ) mem min",119000,119000,0,0,
151000,43,Ao thun Summer Bear unisex N7 Basic Tee phong tron nam nu tay lo form rong oversize,350000,199000,5,1,3
0,0,"Quan jogger The thao, Gym Nam tron, soc chat gio du mem min, thoai mai, co dan tot",49000,49000,2,1,10
0,0,"Ao thun One Piece Luffy T14, ao phong One Piece Zoro Unisex Nam Nu co Size be tu 25-95kg ",115000,115000,5,1,3
0,0,Ao Dong Xuan Nam Xuat Nhat Maxtino Chat Cotton Thoang Mat (Coc Tay / Ba Lo),48000,48000,5,1,8
0,0,Quan Dui Nam Mac Nha - Freesize ( 40-70kg ) giao mau ngau nhien,35000,35000,5,1,252
0,0,Ao Hoodie ni  Couple nam nu - Form rong ,75000,75000,0,0,
156000,30,"Ao so mi nam tay ngan tron AKUBA form regular, vai linen nhe, tham hut cuc tot, chat lieu than thien moi truong 01M5016",515000,359000,5,2,3
11000,7,Quan Dui Nam Dai chat dui sieu mat,156000,145000,5,5,27
170000,45,Quan kaki dai nam chat vai cotton co gian sieu dep LADOS - 4032 thiet ke ton dang tre trung,379000,209000,4.8,6,9
0,0,Quan boi nam dang lung cao cap,109000,109000,4.8,5,21
0,0,Bo do vo dien cho Halloween cosplay hoa trang phien ban anime Nhat Ban,485000,485000,0,0,
0,0,Quan jean nam den ong dung dang slim Fit- vai jeans bo co gian 4 chieu cao cap,0,149000,4,3,
0,0,Combo Hop 4 Quan Sip Dui Nam Thong Hoi + Tang 01 Tat Co Ngan (Giao mau ngau nhien),90044,90044,3.9,17,161
0,0,"Ao Khoac Nam Chat Gio Pmax (3 mau), Co 2 Lop, Co Mu, Dang Tre Trung, Chong Tham Nuoc, Chong Gio, Thich Hop Nam Nu",169000,169000,5,12,22
0,0,Ao Dui Nam Dai Tay Co Tau Cuc Tet ROUGH,149000,149000,3.8,9,42
250000,28,"Ao khoac Blazer nam AKUBA, form slimfit, vai det fresco nhap khau, lop lot cotton lua cao cap, mem min 01K0074",899000,649000,4.6,7,12
0,0,Quan Short Thun The Thao Nam Akuba | 01J2856,389000,389000,4.5,2,4
144000,44,"Quan Short Jean Nam co dan kieu dang tre trung don gian Thuong Hieu Chandi, quan sot mau moi xu huong 2021 QSJN237",324000,180000,4.7,13,28
0,0,Ao so mi nam dai tay mau Hong phan,149000,149000,4.3,6,9
150000,50,Ao Phong Nam Polo Phong Cach Hien Dai Tre Trung Cao Cap VICERO,300000,150000,4,2,11
0,0,QUAN SHORT KAKI NAM,85000,85000,4.1,20,35
0,0,Quan Dui In Gau Cuc Hot - Form Unisex Freesize 38-70kg Nam Nu,49000,49000,4.5,2,8
0,0,"Ao ba lo thun lanh, Ao ba lo tank top",68000,68000,5,1,1
0,0,AO HOODIE NI NAM NU PHOI 2 MAU Unisex hoodies ao khoac ni nam nu,75000,75000,3,1,3
0,0,AO THUN UNISEX NAM NU IN MAU LOANG VAI THUN COTTON UNISEX LOANG 3D SAMEXOY,56000,56000,5,1,3
0,0,Ao giu nhiet lot ni cho ban nam,39900,39900,5,2,4
0,0,"Ao chong nang DAP VAN nam nu  , Chat Vai UMI day dan Sieu Mat - GIAO HANG HOA TIET NGAU NHIEN",95000,95000,0,0,1
0,0,"Ao so mi nam co tau xam tieu, so mi nam co tau chat lieu dui cao cap thoang mat",216000,216000,5,2,2
0,0,"So mi ngan tay nam, chat lieu dui, thiet ke tre trung nang dong ",99000,99000,5,2,3
0,0,"Quan tay nam cao cap chat vai tuyet mua, co gian 4 chieu Han dang om body chong nhan tuyet doi",99000,99000,5,2,4
0,0,cac kieu ao thun nu cho nguoi map beo de thuong,75000,75000,5,1,1
0,0,Ao thun big size nam gia re - Ao Phong Nam - Ao Thun Nam Size Lon,68000,68000,5,2,5
0,0,Bo quan ao dui nam chat vai dui thai loai day dep hang hot trend BDC2021,108000,108000,5,2,8
0,0,Ao thun nam nu meo deo day co bigsize,132000,132000,4.7,14,33
0,0,Ao so mi nam tay dai 4YOUNG vai lua cao cap KHONG NHAN SM1 - Trang - L,74000,74000,0,0,37
0,0,AO KHOAC JEAN  IN CHU CO MU TRUM - GV5161,132000,132000,3.9,8,11
0,0,Ao So Mi Nam Trang Hoa Tiet Chim Bay ,99000,99000,4.7,3,6
0,0,Ao Khoac Jean Nam Tron In Chu Ca Tinh,170000,170000,5,1,2
0,0,Ao So Mi Nam Han Quoc Lich Lam,125000,125000,3.8,13,180
0,0,Ao So Mi Nam Phoi Mau Tia Set,89000,89000,1,1,1
0,0, AO SO MI NAM VIEN CO THEU LOGO CON ONG,99000,99000,1,1,4
0,0,Ao Thun Ao Phong Nam Nu Tron Vai Day Chuan Cotton Bao Bao Store,34000,34000,5,1,9
0,0, Ao So Mi Nam PHoi Mau Hoa Tiet US ARMY ,110000,110000,4,3,6
0,0, Ao So Mi Nam hoa tiet kien ,110000,110000,4,1,
0,0,Ao phong nam nu co co - Ao thun nam co co big size - Kieu Ao thun danh cho nguoi map,68000,68000,4,3,7
0,0, Ao thun unisex nu gia re - Ao kieu big size - Ao thun danh cho nguoi beo bung,68000,68000,5,1,3
0,0,Ao Thun Unisex Bad Habits Tobacco Mau Cream 100% Cotton - Local Brand Chinh Hang,350000,350000,4.5,2,3
0,0,Ao hoodie The Bad God World,450000,450000,5,1,
0,0,"Ao thun hoa tiet phan quang in lung , mac doi mac nhom sieu xinh 65",25000,25000,1,1,1
199000,67,Ao Phong Nam Dep Khong Co Tron Tay Ngan 6 Mau Phong Cach VICERO,298000,99000,4.5,44,110
90000,23,Combo 3 Ao thun nam co be vai ca sau - EZ338,389000,299000,4.3,138,247
74000,16,Ao Khoac Nhung Lot Long chat lieu nhung cao cap - lot long cuu mem min K13,450000,376000,5,1,
0,0,Ao Khoac Nhung Lot Long nam tinh sieu am K13,460000,460000,5,1,
0,0,"Set Bo Bo Sua From Rong Unisex , Do Bo Mac Nha Tay Lo Freesize, Nam Nu Deu Mac Duoc",50000,50000,0,0,
36000,31,[ Co Anh That ] Ao thun unisex tay lo form rong - phong gau Teddy,115000,79000,4,5,5
0,0,Quan short nam the thao ma TT10 Quan dui nam ngan co gian mua he dang lung thun tron vai co gian co day rut,95000,95000,3.5,2,11
59000,50,Ao thun nu nam form rong giau quan unisex phong basic teen co tron cotton oversize gia re in style ulzzang STARTEIGHT,118000,59000,1,1,2
59000,50,Ao thun nu nam unisex tay lo phong form rong teen co tron oversize cotton gia re basic den trang tee pull freesize LOKOSTRY ,118000,59000,4,1,2
59000,50,Ao thun nam nu unisex basic tee form rong phong co tron cotton oversize trang den ulzzang gia re in cool ngau RELY ON,118000,59000,5,1,2
119000,50,Ao hoodie ni ngoai ulzzang nam nu unisex cap doi sweater local brand khoac zip choang cardigan chong nang NARUTO & HINATA,238000,119000,4,1,4
0,0,Ao khoac da lon nam Amintino chat lieu da lon thiet ke tre trung,200000,200000,4,2,16
59000,50,Ao phong nu nam unisex tay lo thun form rong teen co tron oversize cotton gia re basic den trang tee pull KHUNG LONG ,118000,59000,4.5,2,5
21000,11,Quan jogger unisex N7 the thao nam nu ni cao cap da ca bigsize thu dong basic pants tap GYM 4 MAU ca tinh,200000,179000,5,1,2
0,0,Ao so mi ngan tay viet tien mau xanh da troi,300000,300000,4,3,6
20000,20,Ao thun nam ngan tay khong co cotton thoang mat FREEMAN TSF313,99000,79000,5,1,13
0,0,Ao So Mi Nam - Ao So Mi Nam Dai Tay Ke Soc AD08,108000,108000,4.6,18,180
50000,25,"Quan short kaki Amazing, lung thun co giay rut, vai kaki day dan, co gian nhe, nhieu mau, co size lon",199000,149000,5,17,68
10000,3,Ao ni nam Casual Sweatshirt thuong hieu Coolmate,329000,319000,5,1,12
0,0,Ao mang to da nam,449000,449000,4.7,3,7
0,0,Ao so mi nam co tru dai tay ke soc trang den,149000,149000,4.5,9,27
0,0,Ao thun Teelab Game Over? TS132,350000,350000,5,1,1
170000,32,Ao So Mi Tay Dai Cong So Nam Form Reugular AKUBA | B414,529000,359000,5,3,6
0,0,Quan lot nam thun lanh Manufie Sip nam Tam giac det soi co gian 4 chieu,19000,19000,5,2,6
0,0,Quan Kaki Nam Dep Dang Han Lung Thun Tien Dung Form Slim Fit Cuc Dep QK045+AO,139000,139000,4.5,2,2
0,0,Ao blazer tay lo unisex ao vest form rong nam he thu phong cach Han Quoc-BZ05,227000,227000,5,2,1
0,0,Quan Tay ( Au ) Nam Dang Han Quoc - Den - 32,81000,81000,1,1,108
0,0,Quan tay au nam dang om vai co gian nhe ben dep phong cach Han Quoc - Den - 29,82000,82000,1,1,
0,0,"quan au nam cong so dao pho cao cap co gian nhe, quan tay nam dang om",139000,139000,4.5,4,8
0,0,Quan Jogger Kaki Den Dang The Thao JOGGER52 - Jogger,85000,85000,0,0,
72000,50,"Bo do nam y hinh, vai em, mat, khong ra mau, khong do long",144000,72000,4.1,8,12
0,0,[ Co anh that ]  Ao thun tay dai tron form rong unisex - Ao sweater tron,74000,74000,4.5,10,19
0,0,Ao vest ghi le nam phong cach Han Quoc,847000,847000,0,0,
0,0,Ao Thun Unisex Bad Rabbit Hustle Mau Cream 100% Cotton - Local Brand Chinh Hang,400000,400000,1,1,8
0,0,Ao thun Teelab Summer Elements TS079,195000,195000,5,1,2
50000,25,Quan Lot Nam Boxer Cao Cap B1155,199000,149000,4.2,10,76
100000,44,Quan Lot Nam Cao Cap QLN1292,229000,129000,4.6,24,388
68000,31,Ao Ni Nam Thoi Trang Tre Trung Chat Vai Co Dan ZERO,218000,150000,4.6,78,288
62800,10,OWEN - Ao so mi nam dai tay dang SLIMFIT soi Cafe Ma AS23360D,628000,565200,5,1,1
0,0,Quan dai Dui nam ong con cap chun day rut,90000,90000,3.3,3,9
0,0,QUAN JEAN NAM DEN RACH PHOI MAU,180000,180000,3.8,15,37
0,0,Ao thun nam co co form rong trung nien vai cotton det rieng cho Thai Khang loai ao thun polo ngan tay TOG7,149000,149000,3,4,23
0,0,Ao thun Teelab Half Dye Basicism TS080,199000,199000,5,2,3
0,0,"(Video ) Ao khoac du , ao khoac cap doi  , ao khoac gio , ao khoac nam kieu bomber vai du ngoai 2 lop",75000,75000,5,3,4
0,0,Ao Ni Nam Hoa Tiet Chu GENVIET T4121H2035,358000,358000,3.5,2,4
0,0,Do bo the thao thun nam phoi dai tay vai thun lanh mac cuc mat,88000,88000,5,1,2
100000,25,Ao Phong Polo Nam YODY Ao Thun Lanh Ke Vien Chat Lieu Pima Co Gian Dan Hoi Tham Hut Tot - APM3013,399000,299000,5,6,21
0,0,Ao Khoac Da Nam Dang Ngan Ao Da Nam Dang Vest Sans19 Sans Shop,0,690000,4.8,6,
0,0,"Ao khoac bomber H0 90, Ao khoac du kieu bomber logo 90 ca tinh, Ao khoac du Bomber chu phoi mau Unisex nam nu, Ao khoac du nam nu mac / ao khoac gio nam nu mac / ao khoac du kieu bomber / ao khoac cap doi / ao khoac form rong",96000,96000,2,1,2
9000,3,Ao thun nam co be chinh hang DOKA dang the thao nam cao cap duoc theu logo sac xao tong mau co ban - Combo 3 ao Xam Xanh den Xanh co vit - DBM30736,305000,296000,4.5,45,70
0,0,"Bo The Thao Nam ROUGH Chat Thun Co Gian,4 Mau Da Dang, Tre Trung",150000,150000,5,3,6
179000,60,Ao Phong Nam Co Co Tron 100% Cotton Cao Cap Tay Ngan Polo ZERO,298000,119000,5,7,33
0,0,(Anh that) Quan jogger cartoon/Quan dai in 3D hoat hinh nguoi nhen ong rong Unisex nam nu thich hop mac cap kem vdeo,99000,99000,1,1,2
0,0,"Ao khoac du nam , ao khoac gio nam , ao bomber du 2 lop - Den,XL",93000,93000,4.7,3,20
0,0,Bo Quan Ao Ni Nam Lot Long Sieu Am Cao Cap NT1,235000,235000,3.6,5,22
0,0,AO KHOAC DU NAM BOMBER HAI LOP PHONG CACH HAN CO SIZE LON 3XL,0,99000,4,1,
0,0,"Quan short the thao nam dang lung, quan dui nam mac nha chat vai mem min mac chuan form khong bai xu 5 mau thoi trang",75000,75000,3.7,36,97
80000,21,Ao Phong Polo Nam YODY Bo Ke Tre Trung Chat Lieu Cafe Khu Mui Chong Tia UV Hieu Qua - APM3791,379000,299000,4.8,14,30
0,0,Ao Phong Polo Nam YODY Bo Ke Kieu Dang Tre Trung Chat Lieu Airycool Thoang Mat Co Gian Tot - APM3959,299000,299000,4.3,8,26
100000,25,Ao Phong Polo Nam YODY Kieu Dang Tre Trung Chat Lieu Coolmax Thoang Mat - APM3519,399000,299000,4.6,18,27
127200,44,"Ao So Mi Nam lua tron cao cap Thuong Hieu Chandi, xu huong moi nhat nam 2021 mau NT26",286200,159000,4,7,28
91000,26,Ao so mi nam tay dai ADINO mau xanh nhat dang slimfit vai modal tre trung S304,350000,259000,4.5,2,2
56000,49,Ao thun ho nach vai thun cotton mem min tham hut mo hoi form 75kg,115000,59000,5,1,1
127200,44,"Ao So Mi Nam Thuong Hieu Chandi, chat lua khong bai nhao khong xu long ton dang om form mau SM8",286200,159000,4.8,21,39
0,0,"Ao thun Polo nam co be BASIC vai ca sau may ki , form dep PoLo T09 - SoHa Clothing",210000,210000,5,2,2
0,0,"Ao thun nam co be vai thun cao cap King168 , ao phong thoi trang nam MS506",100000,100000,3,1,
0,0,Ao Thun Nam Phan Quang 7 Mau Joker Unisex,60000,60000,4.5,8,18
0,0,"Ao Thun Nam_ Nu  Phan Quang In hinh DOA HOA , ao chat, di dem, di phuot bao ngau, nhin da mat",60000,60000,4.6,12,32
143200,44,"Ao Khoac Nam, Khoac Du Nam 2 lop phoi non khong thao roi thoi trang han quoc tre trung cuon hut Julido chat lieu tham hut mo hoi day dan mac thoang mat KD55",322200,179000,4.5,11,50
111200,44,"Do Bo The Thao Nam thuong hieu Chandi, Do Bo Mac Nha chat lieu thun cao cap mat me, tham hut mo hoi tot MS902",250200,139000,4.2,5,18
0,0,CATSA Ao Polo trang phoi do ATP221,350000,350000,5,1,
0,0,"Ao Thun cho ca Nam va Nu Phan Quang In CUC PIN_ FULL LOVE , ao chat, di dem, di phuot bao ngau, nhin da mat",59000,59000,5,2,3
0,0,Ao sweater co V form rong oversize unisex nam nu chat lieu ni bo det diem nhan rua cau vai,135000,135000,5,1,2
0,0,Combo 4 quan Jones 301,88000,88000,5,1,2
0,0,Ao thun sat nach Wind unisex tanktop form rong Tron nam nu oversize ulzzang,70000,70000,5,1,3
0,0,BO THU DONG NAM DAI,279000,279000,2.5,2,14
0,0,"( COMBO 3 ) Quan ngu nam ,quan dui cotton cao cap nhieu mau sac, mac nha",100000,100000,4,1,1
0,0,Ao thun tay lo Wind phong unisex form rong Meo Ly nam nu cotton oversize ulzzang,80000,80000,4,1,1
91000,20,Ao len gile Aligro ALENGL012,455000,364000,5,3,4
0,0,Ao thun tay lo Wind phong form rong Sunday pull nam nu oversize cotton ulzzang,63000,63000,5,2,3
50000,31,"Quan dui nam dang lung , chat dui mem mat, thoi trang phong cach tre",159000,109000,5,1,2
0,0,"Ao Free Fire Mau Den Rank Huyen Thoai, Ao thun nam coc tay rank Free Fire mau den, co tron, chat thun mat, mem mai, co gian 4 chieu, du size cho nguoi tu 20kg - 85kg, Phom ao phu hop cho ca nam va nu",85000,85000,4.7,29,100
0,0,Combo 5 Quan lot tam giac nam Body Silver thun lanh - hang Viet Nam(giao mau Ngau Nhien),185000,185000,4,1,2
0,0,"Ao Thun Nam co co Ca Sau dep, Ao phong nam co co chat lieu cotton thun form dep",99000,99000,5,2,3
46000,20,Ao khoac kaki nam 2 lop Hahaman cao cap mau moi 2021 AKK41 nhieu mau,235000,189000,1.7,3,13
0,0,"Ao khoac jean nam basic LB phom Unisex, vai xe vai jean (bo) khong co gian, day dan, duong may sac sao AKJ12",250000,250000,2,1,1
0,0,Sieu chat Ao Thun Among Us Hero Team - Ao Hero Team mau moi cuc dep,89000,89000,5,1,1
50000,16,"Ao len nam co 3 phan, chat len day dan am ap, thich hop mua dong, hang nhap Quang Chau",319800,269800,3,1,11
0,0,quan kaki tui hop nam trung nien linh my cuc ngau hang dep co gian,280330,280330,4,1,2
0,0,AO KHOAC DU NAM HOA TIET 3D,195000,195000,1,2,1
0,0,Ao so mi nam tay ngan phoi hoa tiet sieu lich lam,95000,95000,5,1,1
0,0,Quan lot Nam thoang mat mau moi - QL05A,90000,90000,4.7,3,29
0,0,AO KHOAC JEANS NAM DAY DAN CAO CAP ao khoac nam ao khoac jean ao khoac mua dong ao khoac nam day ao nam,229000,229000,1,1,2
0,0,quan short jean nam,149000,149000,5,7,11
0,0,- Ao thun nam POLO thiet ke vai ca sau cao cap ngan tay cuc hot ,89000,89000,5,2,8
0,0,[COMBO 4] Quan Lot/Sip nam cao cap BADBIRD - Dang Boxer - Made in Viet Nam,260000,260000,5,1,1
0,0,Ao Thun VANQUISH Trang Nam Chuyen Tap Gym Cao Cap,99000,99000,5,1,1
0,0,"Ao len nam ZENTOMAN long tho co polo mem min, giu nhiet, co gian P92",288000,288000,1,1,1
0,0,AO THUN NAM BA LO THE THAO CO GIAN TOT,149000,149000,5,1,7
0,0,"Do boi nam, quan boi nam SPEEDO lung thun, vai co dan 4 chieu nang dong thoai mai",75000,75000,5,1,
0,0,AO KHOAC DA NAM DEP CA TINH,369000,369000,4,1,
301000,35,"Ao phao nam AP54 , ao khoac nam dang phao hoodie mu lien kien dang bo tay, bo hong phong cach Han Quoc doc dao",850000,549000,0,0,2
0,0,"(TANG THAT LUNG SIEU BEN) Quan Kaki Nam Tui Hop Linh My Cao Cap, Quan kaki Nam_Quan tui hop_Quan linh My_Quan con o",599000,599000,5,1,2
0,0,Ao thun nam nu unisex form rong chu kieu ca tinh vai day min AT56,25000,25000,3,1,1
0,0,Ao khoac jean nam MD A85 loai tot,229000,229000,1,1,
0,0,Ao thun nam nu cao cap vai cotton xin co dan vai mat mau hot 2021 Phuongnamshop20 m45,77880,77880,3,1,1
0,0,Ao Thun Unisex T01 phong tron nam nu tay Ngan oversize form vua  4 mau,75000,75000,5,1,1
50000,14,"Ao vest Blazer Linen nam dang lung, thoi trang phong cach tre trung",350000,300000,3.5,2,4
0,0,Ao phong nam - Bach Ho 3D Let's Me Out,125000,125000,5,1,1
0,0,"Quan short DUI nam dang slimfit, chuan thiet ke Han quoc, cuc ton dang, lich su, tre trung",69000,69000,3,1,3
100000,50,"BO THUN THE THAO NAM HAHAMAN ,GYM THEU LOGO CAO CAP BTT0606 mau xanh",199000,99000,3.5,2,3
0,0,Ao thun polo nam soc ngang co co vai ca sau cao cap tre trung ND07,149000,149000,4.7,12,25
35000,39,Ao thun the thao mua he tron Hahaman haha0513 nhieu mau,90000,55000,3.8,6,20
90000,31,"Ao so mi nam Amazing ke soc dung, dai tay, phong cach cong so thanh nha, form xuong, than rong, vai Bamboo",289000,199000,1,1,1
0,0,Ao thun tay lo unisex Wind phong form rong cotton SPODY nam nu oversize ulzzang,80000,80000,5,2,5
0,0,Ao so mi jean nam dai tay phoi mot ben tui Ma A965 Thoi trang Mix-up shop Len form cuc chuan,165000,165000,1,1,4
0,0,Ao So Mi Nam Tay Dai  SM535 XANH,190000,190000,4.3,6,23
0,0,- Ao thun tay ngan Be Yourself unisex size M L - TUAN LOC NOEL,78375,78375,5,1,3
0,0,QUAN SUONG ONG RONG PHONG CACH - MA 1130,169000,169000,3,2,5
0,0,"Quan the thao NAM NU, quan jogger ong suong 3 soc 1 soc chat day dan, khoa tui cao cap MAU MOI NULY",125000,125000,3,1,1
0,0,Viettien - Ao so mi nam dai tay hoa tiet 1P1166 regular,475000,475000,5,1,
0,0,"Ao khoac gio lot long cho nam nu, ao gio chong nuoc giu nhiet mac sieu am trong mua dong - AGL",299000,299000,5,1,2
0,0,"Quan Sot Nam ️️ Quan Short Jean Nam Den Chat Bo Co Gian, Khong Nhan, Khong Xu Thoi Trang To To Shop - QSJNM212",109000,109000,4,1,
0,0,Ao doi nam nu Gau weekend form rong cuc hot hit,75000,75000,5,1,2
0,0,DO BO SET THE THAO NAM THUN ME CO GIAN,85000,85000,1,1,3
0,0,Ao polo basic mau nau thuong hieu MrTwins,249000,249000,3,1,2
0,0,Quan Ni Nam Thu Dong Chat Da Ca Du Xin Quan Mac Nha Nam,85000,85000,2.5,2,16
0,0,QUAN JOGGER KAKI NAM TUI HOP KHOA KEO IN CHU BN,119000,119000,4.7,3,4
51000,15,Combo 3 cai quan thun nam quan dui nam thoang mat co tui rong TKQDCR02 PigoFashion giao mau ngau nhien,330000,279000,5,1,5
61000,34,Ao so mi nam caro cao cap ngan tay NT98 nau,180000,119000,3.3,4,11
0,0,"Ao Thun, Ao Phong Nam , Nu, In Hinh Chu Chuot Hoat Hinh Dang Yeu - Mau010",148900,148900,4,1,1
0,0,QUAN SHORT KAKI NAM LUNG THUN CAO CAP,99000,99000,3.9,10,243
81000,41,Ao so mi nam caro cao cap ngan tay NT216,200000,119000,5,2,4
0,0,Quan dai kaki nam tui hop ,290000,290000,3,2,6
127200,44,"Quan jeans nam co dan , quan bo nam kieu tron dang vua khong bo sat thiet ke tre trung don dieu pha cach gom 5 kich thuoc (28-32) Julido mau THU04",286200,159000,4.7,34,65
0,0,Combo 3 quan lot nam/ sip nam cao cap - mem min sieu thoang - H05,90000,90000,4.8,4,4
0,0,AO SO MI NAM DAI TAY PHOI SOC KHONG NHAN,215000,215000,5,1,3
0,0,Ao thun sport nam,55000,55000,4,3,18
0,0,Quan shorts nam tui hop vai dep chat luong cao ,179000,179000,3.6,5,7
0,0,Combo 3 quan lot nam/ sip nam cao cap - mem min sieu thoang - H03,81000,81000,4.8,10,18
0,0,Ao thun One Piece mau den in hinh Luffy dep gia re,115300,115300,5,1,3
650000,50,"Bo vest nam 2 nut form suong mau den chat lieu co dan , thoang mat tang kem combo phu kien",1300000,650000,4.8,6,8
0,0,Ao khoac gio nam vai du co size lon big size ND02,225000,225000,4.6,5,6
0,0,Quan Short Nam Chat lieu KaKi Namminh,99000,99000,4,2,6
22000,5,"Combo 3 Chiec Quan Lot Nam Boxer Cao Cap, Sieu Nhe, Det Lien, Co Dan 4 Chieu Than Thien Voi Lan Da Aristino ABX064 (Giao Mau Ngau Nhien) - Hang Chinh Hang",447000,425000,4.2,9,19
0,0,Quan Short Nam Lung Co Gian Size Dai Cao Cap NamMinh,119000,119000,4.3,15,36
111200,44,Quan short jeans nam eo co dan mau xanh loang 1 ti bac san lai thiet ke phong cach thoi thuong dao pho Julido mau JS097612 thoi trang han quoc,250200,139000,4.7,7,16
111200,44,"Ao so mi nam SM03 , ao nam vai lua co dan hoa tiet NGOI SAO nhe phong cach han quoc tre trung thoi thuong nang dong mau JJ0123 gom 3 size (M L XL) kieu dang da dang khong xu long",250200,139000,4.5,18,38
61000,41,Quan Short nam lung bo tui khoa keo hang hieu phong cach chuan QTTN07 chon lua mau,150000,89000,4.7,7,19
0,0,Ao Khoac Hoodie Unisex (HD-Cau Vong),49000,49000,4.2,11,87
0,0,AO SO MI NAM HAN QUOC CAO CAP HOA TIET KE CARO SANH DIEU CHO PHAI MANH( nhieu mau)- BONG 2020,205000,205000,4.5,14,25
0,0,Quan lot nam sexy - trang,49000,49000,4.2,9,36
0,0,"Ao nam, gia hai lop, co tron, dai tay, chat thoang mat, thoi trang, phong cach Nhat Ban TA85",400000,400000,4,1,1
0,0,Bo quan ao the thao sieu hot chat luong cao (BTN-031),59000,59000,2,1,2
0,0,Bo The Thao Nam Dai Tay - Bo Thu Dong Chat Lieu Ni Cao Cap Mem Min - BD52,189000,189000,4.8,4,9
0,0,"Combo 3 Chiec Quan Lot Nam Cao Cap CALUCI CA 08, Chat Lieu Soi Tre Tu Nhien Khang Khuan, Khu Mui Tu Nhien (Giao Mau Ngau Nhien) - Hang Chinh Hang",360000,360000,5,15,28
0,0,AO THUN NAM NU UNISEX MV36-38,79000,79000,5,1,2
0,0,Ao Free Fire Ao Thun Free Fire Co Tron Mau Trang Cotton Co Dan 4 Chieu Thich Khach Am Duong Cuc Dep,83000,83000,4.2,5,15
0,0,Quan lot nam Hunk Bikini ho suon mau xanh ngoc,129000,129000,5,2,12
0,0,Ao so mi nam tay lung Orange Factory Han Quoc EQK1L301,89000,89000,4.3,3,5
0,0,"Ao Thun Nam Phan Quang In ao luc dao, anime Naruto , ao chat, di dem, di phuot bao ngau, nhin da mat",59000,59000,4.6,20,39
61000,25,Ao thun ao phong nam ngan tay co co big size co tren 80kg TKPB01 PigoFashion chon nhieu mau,240000,179000,5,2,5
0,0,quan short  kaki  co gian 4 chieu kieu tay au den tu Thuong Hieu Nam Minh,139000,139000,4,5,30
0,0,Quan Jogger Nam Tui Co Khoa Keo,59000,59000,4.7,3,9
0,0,QUAN JEAN NAM TRANG PHOI MAU CO GIAN,185000,185000,5,1,2
0,0,"VARDINO ao khoac nam kaki jacket cao cap dong cuc co be - co dung, tron - hoa tiet, mem - min - nhe - khong nhan - khong phai - chong nuoc chinh hang dang xuong - om vua - vat bang cong so trung nien moi ak38",895000,895000,2.5,2,4
0,0,Quan Jean Nam Jogger ca tinh A5,215000,215000,4.5,5,6
0,0,Ao Thun Among Us Mau Den Hinh Do In 3D Chat Lieu Mem Min Hinh In Sac Net Du Size Danh Cho Ca Nam Va Nu,85000,85000,4.8,13,20
0,0,Ao Thun Doi Nam Nu Loang Mau Phan Quang ,79000,79000,3,5,5
0,0,Combo 2 Ao thun 5THEWAY Tay Ngan Logo Den aka 2 PACK 5TW/RTW TRADITIONAL FIT TEE in BLACK LOGO,460000,460000,5,1,3
176000,44,"Quan jogger nam the thao Julido Store, chat kaki bo chan xu huong moi nhat JD02",396000,220000,4.2,9,17
26000,50,Ao lot Nam cotton trang sieu dep,52000,26000,1,1,6
0,0,Ao Thun Unisex Bad Rabbit THE EARTH 100% Cotton - Local Brand Chinh Hang,350000,350000,5,1,1
0,0,"Ao Thun Nam In Hinh Ngoi Sao Co Dong Thoi Trang, Vai Cotton Day Min, Thoang Mat",58000,58000,4,1,1
161000,54,Ao so mi nam caro cao cap dai tay SM070,300000,139000,3.9,14,45
0,0,Ao Khoac Gio Nam Lot Long Cuu Chong Gio Lanh Mua Thu Dong Chat Lieu Cao Cap-Xanh Reu-M,159000,159000,5,2,4
50000,31,Quan Shorts Kaki Nam HAK11,159000,109000,1,1,1
0,0,AO KHOAC NAM KAKI DEN- THOI TRANG BUI- CHUAN SOAI CA,165000,165000,4.5,5,15
0,0,Quan Tay Au Nam Dang Om Vai Co Dan Nhe,93000,93000,2.5,16,167
0,0,Ao khoac kaki nam cao cap,175000,175000,5,1,18
0,0,"Quan Jean Nam Mau Xanh Mau Moi, Phong Cach Thoi Trang Cao Cap ms122",137000,137000,4,1,2
0,0,Ao giu nhiet nam co 3 phan,220000,220000,2,1,
0,0,"Quàn jean, quan bo nam kiẻu phong cách hot trend 2021 msa17",137000,137000,5,2,2
176400,30,OWEN - Áo So mi dài tay Owen Regularfit 80420 chát sọi tre- Ao so mi nam dai tay,588000,411600,4.5,2,6
0,0,"Quàn Jean, Quan Bo Nam kiẻu phong cách han quoc hot trend 2021 msa31",137000,137000,4.8,5,12
0,0,Quan Jean Nam Chat Bo Rach Goi Cao Cap Co Dan Phong Cach Thoi Trang ms50,137000,137000,5,1,1
103000,30,"Ao Chong Nang Nam TSIMPLE, Ao Khoac chong nang nam chat vai kim cuong sieu mat ",342000,239000,5,2,5
0,0,"Ao so mi nam tron, tay dai - DEN - L",99000,99000,0,0,1
0,0,Ao thun Bad Rabbit Unisex - Bad Habbits Tee - Ao phong Tho Nau Tho Hong Oversize Form Rong Tay Lo,310000,310000,5,4,18
0,0,"Ao thun nam mau in Meo Than Tai sieu ngau, Mau mac moi lua tuoi AT50",28600,28600,1,1,1
24500,50,Ao thun co tron den tron chat lieu Cotton co dan 4 chieu,49000,24500,1,1,5
0,0,"Ao so mi nam dai tay kieu dang Han Quoc , vai lua thai mem min , chong nhan cao cap.(CAM KET ANH THAT)",169000,169000,2.3,3,3
0,0,Quan Sot Nam ️️ Quan Short Jean Nam Den Phoi Rach Chat Bo Cao Cap Chuan Hang Shop To To Shop - QSJNM232,129000,129000,4.1,9,17
0,0,Set do Haori nam Kimono Yunhe Jiuxiao phong cach Nhat Ban sieu chat BSK08,192500,192500,4.5,2,3
0,0,combo 3 Quan boxer xi dui nhat,64000,64000,5,1,1
0,0,Ao hoodie phan quang SINO chat ni ngoai cao cap,47530,47530,4,2,2
0,0,Ao so mi nam tay dai form rong hoa tiet vai lua S6,252000,252000,5,1,1
0,0,Ao khoac gio cao cap nam trung nien day am( xem video ),420000,420000,4,1,2
0,0,Do bo di bien. dong phuc gia dinh. mau bong dua,58000,58000,5,6,8
0,0,"Ao So Mi Nam LB Dai Tay Chat Lua Mem Min , In 3D Soc Caro",150000,150000,1,1,1
0,0,"Quan jogger nam 1 soc nho thun POLY min mat, co big size den hon 80kg",79000,79000,5,1,
0,0,AO THUN NAM DAI TAY CAO CAP PHOM BODY HAN QUOC,149000,149000,4,1,1
0,0,Ao Thun Nam Motorcycle - Biker T-Shirt Den in TRIUMPHS - MOTOR T-SHIRT,416000,416000,5,2,2
0,0,HIGHCLUB Unique Tee - Green/White/Grey/Black,280000,280000,5,1,1
0,0,"Ao thun wash acid. ao form rong tay lo. Streetwear, Vai day ,dung form Dinh luong 230gsm chuyen cho Local Brand",119000,119000,5,1,1
0,0,quan dui the thao nam - quan dui nam mac nha - ma QDTGiacMau,40000,40000,5,1,1
0,0,Quan Au nam Xam Sang Vai Cheo Loai Dep Quan Tay Nam co dan khong nhan dang han quoc,89000,89000,3.9,30,64
0,0,Ao so mi nam ngan tay phoi 3 mau tone Pastel Thoi trang nam tinh,125000,125000,4,1,2
0,0,AO KHOAC DU NAM AO KHOAC NAM CHO MOI THOI DAI ,250000,250000,5,1,5
0,0,5THWAY /two tone/ COURT JACKET in CRYSTAL ROSE aka Ao Khoac Du Hong,630000,630000,5,1,1
0,0,Ao Khoac ao bomber DCoins Embroidered Varsity Jacket Red tay den,199000,199000,5,1,
0,0,Quan the thao nam 3 soc- Quan Jogger Nam Thu Dong,139000,139000,4,3,8
0,0,QUAN JEAN NAM VULCANO 1007,511200,511200,1,1,1
56800,10,OWEN - Ao so mi coc tay soi Nano dang Regular Ma AR22930N,568000,511200,5,1,2
0,0,Quan ngo nam the thao - ma QNuntitled,55000,55000,4,1,3
0,0,"Ao Khoac Jean OLDMAN, Ao Khoac Kaki Nam Basic Cuc Dep, Phong Cach Co Dien, Manh Me",249000,249000,5,1,
49000,20,Ao khoac du nam co dung 2 mat cao cap co da quang sau lung AKD003,249000,200000,5,1,2
144000,44,"Quan Short Jean Nam co dan kieu dang tre trung don gian Thuong Hieu Chandi, quan sot mau moi xu huong 2021 QSJN305",324000,180000,5,7,13
0,0,"Quan dui nam cap chun - Quan the thao nam chat dui form rong,full size 35-95kg",140000,140000,5,3,7
120000,44,"Ao Thun Nam Cotton in hoa tiet 2 mau trang den thuong hieu Julido Store, ao phong co tron basic coc tay thoang mat, tham hut mo hoi - Hang chinh hang AT01",270000,150000,4.5,34,61
0,0,"Ao thun tron polo thoat nhiet Nhat Ban GOKING, chat lieu 100% cotton sieu thoang mat, danh bay con nong mua he",215000,215000,5,14,20
0,0,"Ao khoac nam AP34 , ao phao nam dang dai co mu phong cach Han Quoc tre trung, nang dong, ca tinh",749000,749000,4,1,
0,0,Quan Sip Dui Nam Cao Cap Quan Lot Nam Dui Co Gian 4 Chieu Mau Ngau Nhien,12000,12000,5,1,10
0,0,Ao Thun Unisex EARTH,38000,38000,4,2,3
140000,39,"Ao khoac Bomber Korea form dep, vai Xi Nhat cao cap, ben trong co lop hut am, thoang mat, hop thoi trang    ",360000,220000,5,2,3
0,0,Ao len nam co tron ke han quoc,150000,150000,5,2,2
0,0,quan short lung thun nam vai kaki mem min,55000,55000,5,1,8
0,0,"Bo do ngu nam, bo coc nam HINH THUYEN",179000,179000,2.5,2,7
0,0,Quan lot nam thun lanh hoat hinh cao cap 3D,31000,31000,5,2,9
0,0,Bo ao khoac the thao thu dong cao cap ,505700,505700,3,2,6
0,0,Ao thun gia dinh Suu ATGDXam84,35000,35000,4.5,25,52
0,0," Ao dui nam dai tay co tau, chat dui xuoc my mac nhe nhu khong atbshop 2020",139000,139000,5,1,2
0,0,"[FREESIZE tu 45-65kg] BELIEVER Ao thun den nam in da quang phan quang trong toi, chup flash",119000,119000,4.5,2,7
0,0,"Ao chong nang nam,ao khoac di nang chat vai kim cuong phien ban moi nhat 2021",195000,195000,2.5,2,2
0,0,Ao thun local brand BOBUI bong bay tay lo unisex,130000,130000,4.7,3,5
0,0,Quan jean nam  Baggy ong rong thoi trang  hop thoi trang Quan ong suong thang,0,182000,4,5,
0,0,Combo 3 ao So Mi nam Den - Do - Xanh Than,255000,255000,3,1,3
0,0,"Quan au nam mau Xam tieu chong nhan, Quan tay nam dang con loai dep",118000,118000,3,1,8
0,0," Bo lung nam phoi tron, Hang chat dui thai 100%. Chat day dan, Thoang nhe, Mem mat, Tham hut mo hoi",199000,199000,3.4,5,9
59000,50,AO BA LO NAM COTTON NANG DONG,118000,59000,2.6,13,30
0,0,Ao thun body ba lo nam Taki Taki,69000,69000,4.7,9,103
127200,44,"Quan jeans nam co dan , quan bo nam kieu tron dang vua khong bo sat thiet ke tre trung don dieu pha cach gom 5 kich thuoc (28-32) Julido mau THU08",286200,159000,3.3,3,6
0,0,"Quan Tay Au Caro Xam Ong Con Vai Dep, Hinh That",135000,135000,5,2,4
0,0,"Ao phong trang, ao ki yeu trang cotton",26000,26000,3,1,1
0,0,Ao Hoodie Lien Minh Huyen Thoai Toc Chien Logo League Of Lengend  2 Mau Den Va Trang Cuc Chat Hinh In Sac Net 2 Mat Kieu Dang Tre Trung,145000,145000,5,1,2
0,0,Ao khoac gio nam KWIN KJK001W8,850000,850000,5,1,1
0,0,AO THUN BA LO NAM CO SIZE 3XL,139000,139000,4,4,4
0,0,AO THUN NAM DAI TAY CO TIM NHIEU MAU,149000,149000,3.5,2,20
144000,44,"Quan Sot Jean nam co dan 4 chieu Thuong Hieu Chandi, phong cach han quoc mau moi nhat 2021 MR8009",324000,180000,5,23,40
0,0,"Quan short dui nam chat dui mem mat, quan sooc lung the thao chuan form cap chun day rut 5 mau",65000,65000,4.3,9,19
0,0,Ao khoac hoodie ni ngoai ulzzang nam nu,101250,101250,4.5,2,4
150000,38,QUAN AU NAM TRUNG TUOI CAO CAP KN43,400000,250000,5,1,4
144000,44,"Quan Short Jean Nam co dan kieu dang tre trung don gian theu hoa tiet Thuong Hieu Chandi, quan sot mau hot nhat 2021 HD219",324000,180000,5,46,125
0,0,"Quan nhung nam ngan hoa tiet FEAER 100% chat Nhung Gan thoang mat, it nhan Budge Short FEAER |new arrival 2021|",299000,299000,5,2,4
0,0,"Bo PIZAMA NAM coc tay-Do bo nam bo he chat vai COTTON 100% day dan, thong thoang (616)",410000,410000,5,2,3
0,0,Quan kate nam,55000,55000,5,1,23
0,0,Ao thun nam thoi trang - thoi trang he,119000,119000,4,1,2
0,0,AO KHOAC PHAO NAM AM AP SIEU PHAM MUA DONG KHONG LANH CUA PHAI MANH MOI BAO DEP,165000,165000,4,1,3
0,0,QUAN LUNG NAM ONG DIA CHI NOI 29-36,250000,250000,5,1,2
0,0,"Quan Dui Nam Kaki Tho Ngan Ke Soc Caro Co Tui Ben SUNMEN ,phu hop mac o nha,tap the thao,thoang mat",35000,35000,5,1,24
111200,44,"Do Bo The Thao Nam mau den co gian tot thuong hieu Chandi, Do Bo Mac Nha chat lieu thun cao cap mat me, tham hut mo hoi tot NT1908",250200,139000,5,20,22
50000,34,"Ao Thun Nam Co Be Doka 4 Chieu Cao Cap, Tre Trung ( Xanh co vit )",149000,99000,4,1,1
0,0,"Quan Jogger dai 3 soc quan nam , tre trung phong cach",120000,120000,5,2,2
0,0,Ao Khoac Jacket Ni Nam Nu Dang Rong Phoi Soc Vai Phoi Da G057,175000,175000,5,1,1
0,0,Quan Short Bien Nam Co My SZone SQ214,149000,149000,4.8,4,6
0,0,"Ao So Mi Nam Hoa Tiet Ke Soc Den CEFFYLO 2, Vai Cotton Mem Min, Form Chuan",190000,190000,5,1,
0,0,Quan Tay Nam Phong Cach Cong So Tre Trung,108000,108000,3.1,8,111
101000,34,quan jean co gian q100 om body Muidoi,300000,199000,3.5,15,178
0,0,Ao so mi trang dai tay vai kate,340000,340000,4.7,3,15
0,0,Quan Dui Nam Dang Tre Trung Mau Den DUIDEN55 - Dui Den,49000,49000,0,0,
0,0,Ao gile tran thu kaki,280000,280000,1,1,10
0,0,AO THUN NAM TAY DAI,149000,149000,4.2,5,10
0,0,Quan short nam chat dui sieu thoáng mát chat dep dang dep,69000,69000,5,29,68
0,0,"Quan Jean Nam Dai Rach Goi, Mau Moi Phong Cach Thoi Trang ms8",137000,137000,4.6,5,13
0,0,"AO THUN THE THAO NAM PHOI 3 SOC CAO CAP,CHAT THUN LANH CO GIAN 4 CHIEU THOA MAI KHI DI CHUYEN VAN DONG",45000,45000,4.5,7,16
0,0,AO KHOAC DU BOMBER CHONG NANG.,91000,91000,4.5,2,2
0,0,Ao len nam co lo 2020 - xuongaolen.com,150000,150000,4.7,3,3
62500,10,OWEN - Quan au nam cong so dang REGULAR cap Tang do co dan soi Nano ma QRT22441 ,625000,562500,5,2,7
0,0,Quan Au Nam Den Theu Vuong Mien Vang VUONGMIEN01,159000,159000,4.1,26,165
0,0,"Ao Phao Nam long vu 2 mat, day 4 lop sieu nhe, sieu am voi 4 tui tien dung",385000,385000,4,2,
0,0,Quan Sip Dui Nam Cotton Cao Cap - Quan Lot Nam Boxer Thiet Ke Basic Chat Lieu Cotton Thoang Mat Thoai Mai Van Dong,45000,45000,5,1,2
0,0,"Ao Thun Nam Cotton The Thao Tron Basic, Ao Phong Unisex Form Rong Den, Trang Co Tron Tay Lo Cao Cap Big Sport",139000,139000,4.5,15,32
0,0,Quan giu nhiet nam Laroma,249000,249000,5,1,2
79200,44,"Ao thun nam the thao tron, co tron dep, tre trung, mac thoang mat, tham hut mo hoi tot thuong hieu CHANDI HH4",178200,99000,4.2,6,9
0,0,Quan Jean Nam chat Bo cao cap ️To To Shop️Quan Bo Nam mau moi phoi xuoc nhe tre trung ca tinh chuan Hang Shop - QJNM76,161000,161000,5,1,1
0,0,"Quan Lot Nam Boxer Xuyen Thau Thong Hoi Lung Nhat Thoang Mat, Quan Sip Dui Thong Hoi Cao cap",49000,49000,4.5,2,12
0,0,Combo Ao thun Teeworld Ua Em va Teeworld Graffity - Washed Tee Nam Nu Form Rong Unisex,828000,828000,5,1,1
127200,44,"Ao Thun Nam Ngan Tay Thuong Hieu Chandi, Chat Thun Cotton Xin Mau Moi NH23",286200,159000,5,4,47
0,0,"Ao Thun Nam Unisex thiet ke hinh tron 2 mau Den  Trang co ban Ai Cap 190gram, ao phong co tron basic coc tay thoang mat, tham hut mo hoi",134000,134000,1,1,1
100000,40,Quan short dui nam Dui Viet DV07,249000,149000,4.5,2,3
0,0,Quan Sot Nam Rach ️️ Quan Short Jean Nam Chat Bo co gian thoi trang Han Quoc form cuc dep To To Shop -QSJNM252,149000,149000,5,1,2
0,0,"COMBO 3 Ao thun ca sau nam cao cap ( Xanh, xam, vang)",169000,169000,2,1,2
0,0,Ao thun polo nam soc ngang Nexx & Dee co co be ca sau lanh mat me trung nien cao cap AM02,159000,159000,5,2,4
159200,44,"Quan Bo Nam cao cap thuong hieu Chandi, chat jean co dan mau moi nhat 2021 MA104",358200,199000,5,36,107
126000,59,Ao thun tay dai nam hahaman co tron thoi trang cao cap mau xam den ATDT04,215000,89000,4.5,2,2
0,0,Ao so mi nam hoa tiet cao cap vai lua thai xin sieu co dan mau ma moi nhat j60,105000,105000,4,1,1
0,0,Quan Au nam Do Do Vai Cheo Loai Dep Quan Tay Nam co dan khong nhan dang han quoc,98000,98000,5,1,1
0,0,COMBO 3 QUAN LOT NAM ROSSO THAI LAN 0303 - MAU NGAU NHIEN,105000,105000,3.3,3,3
0,0,Ao khoac Hoodie Nui Tim Unisex,390000,390000,1,1,2
0,0,Ao thun dai tay thu dong nam trung nien chat dep nhieu mau,199000,199000,5,2,3
40000,10,OWEN - Ao so mi trang coc tay dang BODYFIT (vat bang) soi Soi BA23116N2,400000,360000,5,1,3
0,0,"Quan Tay Au Nam Cong So, Dang Om , Ong Con, Phong Cach Han Quoc",125000,125000,5,1,2
0,0,Quan Jogger Ni Theu SPUN Bo Ong Nang Dong Tre Trung,59900,59900,5,2,6
0,0,AO KHOAC KAKI NAM 2 LOP BO SOC ,349700,349700,2,1,1
0,0,Bo Ao Free Fire cotton mau trang co tron + Quan Short nam in hinh Quy kiem da xoa,145000,145000,3.8,5,18
0,0,Ao thun Paw Patrol cho cuu ho cho tre em | chat dep | Ao Chat Store PA04,0,130800,4.5,2,
0,0,"Ao khoac nam, nu hoodie ni de thuong cao cap cho bon mua, do doi nam nu",109000,109000,3,2,2
0,0,Ao so mi nam Tay lung SM86,49000,49000,4.2,5,27
0,0,Ao Thun Nam Co Tron Ngan Tay AT1079 - Xanh Reu,50000,50000,4,1,2
0,0,Quan Dai Thun Nam Ong Om Bo M88 - Den,250000,250000,4.5,5,27
0,0,Quan Kaki Nam Rockstar Thun Man99 - Xanh Duong,300000,300000,5,1,
0,0,Quan Jean Nam Dep ️️ Quan Bo Nam Mau Moi Chat Lieu Denim Cao Cap Thoi Trang Chuan Hang Shop To To Shop -QJN47,169000,169000,5,1,2
0,0,Ao Giu Nhiet Nam,52250,52250,3,2,13
0,0,"Ao khoac phao nam dang dai tran bong 3 lop , ao am mua dong sieu nhe, sieu day, sieu am ,theu hoa tiet chu cuc hot t",159000,159000,3,2,6
0,0,QUAN SHORT AU NAM - Den - 32,135000,135000,0,0,26
0,0,QUAN SHORT AU NAM - Xam nhat - 32,135000,135000,0,0,19
0,0,QUAN SHORT AU NAM - Do - 29,135000,135000,0,0,19
0,0,ao khoac jean nam suoc,160000,160000,5,1,3
149000,37,"AO KHOAC LOT NI, MAC DUOC 2 MAT- HANG VNXK (ao long vu, ao khoac long vu)",400000,251000,5,2,6
1000,1,QUAN SHORT KATE SPANDEX FEZZIO CHINH HANG FZ-05 NEO,85000,84000,5,1,3
0,0,Ao Thun Nam Everest AoKNAM95 - Trang,195000,195000,5,1,27
0,0,Ao Thun Nam In Hinh Nha Ngoi Cam Everest AoKNAM41 (Trang),195000,195000,4.8,5,153
0,0,Ao Thun Nam In Hinh YouTube Everest AokNAM396 (Vang),200000,200000,4.5,10,35
0,0,Ao Khoac Da Nam Lot Long Thu Dong AN59,349000,349000,4,1,1
0,0,Ao so mi Titishop SM467 tay ngan phoi soc,229000,229000,0,0,4
71000,47,"Ao Thun Nam KOJIBA Ngan Tay, Co Tron Kieu Dang Tre Trung, Chat Lieu Cao Cap (Nhieu Mau)",150000,79000,3.3,6,44
0,0,Ao So Mi Nam Dai Tay SMH18 - SMH18H,300000,300000,4,2,3
0,0,"Ao Thun Nam, Ao Phong Nam FAJA Co Tron, Chat Lieu Cao Cap (Nhieu Mau)",69000,69000,3.4,39,444
0,0,Quan Short Nam Q157 cap lunh thun MD (Xanh den),95000,95000,5,4,22
101000,59,"Quan Shorts Dui Nam KOJIBA Kieu Dang Don Gian, Tre Trung (Nhieu Mau)",170000,69000,3.4,63,1192
0,0,"Ao Khoac gio thoi trang Miuzi ao varsity 2 lop ,vai chan gio phong cach thoi trang gioi tre DT031",262000,262000,1,1,4
0,0,"Ao Dui Nam, Ao Dui Coc Nam Sieu Dep Sieu Mat, Dang Tre Trung Cao Cap Hot 2020 - atb shop",99000,99000,4,1,1
0,0,Ao khoac hoodies co mu nam hoa tiet cuc chat,79000,79000,5,1,
0,0,Ao So Mi Nam Co Tau Trang Tron Min TRANGTAU50 - Trang Tau,70000,70000,3.5,2,4
0,0,Quan lot nam dang luoi trong suot goi cam - Mau tim,49000,49000,4,3,28
0,0,Ao Len Nam Co Lo Loai Day Bs67,396000,396000,0,0,
0,0,Ao Phong ao thun Meo Simmy -Hero Among Hero Team,115000,115000,1,1,2
159200,44,"Quan Jean Nam cao cap co dan 4 chieu Thuong Hieu Chandi, phong cach han quoc tre trung ca tinh MR9054",358200,199000,5,29,38
0,0,"Combo 5 Quan Sip Dui Nam Munafie Det Kim Mau Moi, Quan Boxer Nam (Freesize tu 45-80kg) - D06",140000,140000,0,0,
0,0,"AO KHOAC DU , AO KHOAC DU NAM CUC CHAT , CO MU CHE NANG SIEU DEP NGAU NHAT 2021 VINA 1HITSTORE",79000,79000,3,2,2
99000,50,<FREE SHIP> Quan tui hop nam chat vai kaki tron day dan y hinh (THtron),198000,99000,4.8,4,8
0,0,Ao Thun Phan Quang Nam- Nu in hinh chim,129350,129350,5,1,1
0,0,Ao So Mi Nam Nu  chat lua khong bai nhao khong xu long ton dang mau moi nhat 2021 ,89000,89000,5,2,6
0,0,"Ao thun Nam Nu Khong co ONEPIECE ZORO 6 TAY MSOP-10 mau moi cuc dep, co size be cho tre em / ao thun Anime Manga Unisex Nam Nu, ao phong thiet ke co tron basic coc tay thoang mat",35000,35000,4.5,4,6
127200,44,"Ao thun nam dai tay Chandi, Chat thun cotton xin bo tay va hong mau thu dong MA32",286200,159000,4.6,13,23
0,0,"Ao polo nam , co det bo len ,ao thun nam co co tay ngan thanh lich POLO-28 - Soha Clothing",199000,199000,3.5,2,9
0,0,"Quan short nam ngan hoa tiet Dri Fit 100% chat du si thoang mat, it nhan - FEAER DENIM",119000,119000,5,2,5
50000,36,"Quan jogger thun nam mau 06, thoi trang tre, phong cach Han Quoc",139000,89000,5,1,2
0,0,Quan Jean dai Nam Beverly Hills Polo Club Slimfit Denim Xanh QJSS20V159,890000,890000,4,1,2
0,0,Ao thun nam tay lo form rong chat cotton loang mau cuc hot,79000,79000,3.5,6,16
0,0,"Quan Short Gio The Thao, Quan Dui Nam Vai Si Du Mau Den Day Rut Trong Thoang Mat Cao Cap Big Sport",129000,129000,4.6,14,48
0,0,Ao Thun Nam EnVyMEN Co Be AXB007 - Xanh Bich,242000,242000,5,2,50
50000,42,SIEU PHAM QUAN NGU FEZZIO COTTON  LUA 4 CHIEU   ,119000,69000,4.8,5,8
0,0,AO KHOAC DU NAM CO NON NHE DEP Y HINH,239000,239000,4.5,2,2
0,0,"Ao thun nam, ao thun nam hoa tiet hieu TORANO TS608",250000,250000,5,1,1
0,0,"Quan sip dui boxer Nhat 4 chieu thong hoi cao cap BIG SIZE SIZE LON (6XL DEN 8XL, 100 DEN 145 KG) thoang khi khang khuan",79000,79000,5,1,2
0,0,AO KHOAC BOMBER/AO KHOAC DU NAM NU UNISEX JUST ONE THOI TRANG PHONG CACH,96000,96000,5,1,4
0,0,Ao thun nam Ao polo nam ngan tay co co PN02 Cotton 100% cao cap phong cach Han Quoc,125000,125000,4,1,1
0,0,"BO PIJAMA NAM coc tay, PYJAMA COTTON 100%, PIZAMA hoa tiet ke soc-Shop Thuy Bong",410000,410000,5,1,3
0,0,Ao thun nam nu  Denim khoi City Cycle - Ao thun tay lo Unisex form rong Local Brand,185000,185000,5,1,1
0,0,Bo Ni Nam The Thao Thoi Trang Cao Cap Vulcano 9002,345000,345000,5,1,
0,0,Ao thun nam Ao thun nam co be hoa tiet Vuong mieng mau PR01 Thiet ke tre trung nang dong,125000,125000,5,1,1
0,0,Ao Free Fire Dai Kien Tuong Tang kem Mu FF - CTCT Shop Aoin3D,108000,108000,5,2,4
0,0,"Ao hoodie One Piece Stampede sieu hot, Chat lieu ni bong",150000,150000,5,1,2
51000,34,Quan short jean Q391 MuiDoi,150000,99000,4.5,13,157
0,0,Ao len nam co lo long cuu Quang Chau 2020 - xuongaolen.com,520000,520000,5,1,2
0,0, Ao So Mi Nam Dai Tay Ke Caro BBR Mau Ghi Xam Chat Lua Tho Mem Cao Cap Dang Body Han Quoc Tre Trung Nang Dong,279500,279500,4.3,3,5
0,0,Ao khoac du nam nu Pilot khoa dong tran bong cuc am cho mua dong khong lanh,225000,225000,3.4,8,18
0,0,Ao Khoac Vest  Nam,300000,300000,5,1,1
0,0,Ao len gile nam aligro do do ke vien,455000,455000,4.3,6,9
0,0,"Ao phong Unisex den trang tay lo form dang rong chat lieu cotton, Ao thun nam Han Quoc - AP03",120000,120000,5,1,1
0,0,AO SO MI NAM HOA TIET THEU CAO CAP CHAY NHAT THI TRUONG KIEU DANG THOI  PHONG CACH MOI,198000,198000,1,1,2
17500,27,Quan Short Nam Lung Thun Gabo Fashion QSLSM,64500,47000,5,1,6
0,0,Quan dai the thao 3 soc quan jogger nam nu chat day dan hang cao cap M10 - NOON.MEN,139000,139000,5,4,10
0,0,Ao thun nam nu co be polo cao cap vai cotton sieu co dan hang chuan shop Phuongnamshop20 m52,87840,87840,5,1,1
0,0,"Ao chong nang nam, ao khoac nang nam chat vai thong hoi kim cuong 4 chieu co mu trum",99000,99000,4.5,2,2
0,0,"Quàn Jean, Quan Bo Nam kiẻu phong cách han quoc hot trend 2021 T&L store msa26",137000,137000,2.5,2,2
0,0,Ao polo ngan tay Nam Beverly Hills Polo Club Regularfit 100% cotton Xanh PMRSS20TL108,840000,840000,5,1,1
0,0,AO KHOAC NI NAM CO NON DAY AM,219000,219000,4.7,3,6
0,0,Quan short nam thun the thao cao cap Gabo Fashion QS2S mau ngau nhien,39200,39200,1,1,13
0,0,AO SO MI NAM CAO CAP KHONG NHAN DEP Y HINH,190000,190000,5,1,1
71000,50,Do bo nam nu ba lo chat vai thun me co gian 4 chieu cuc hot (13),142000,71000,1.5,4,6
0,0,Quan sip nam chat lanh QLNTL8 -Joforbaby,36000,36000,5,2,9
0,0,QUAN JEAN NAM CAO CAP Y HINH,189000,189000,5,1,3
0,0,Ao Thun tay lo Nam Nu Unisex co tron phan quang ao thun Circit unisex ngan tay khong co vai co gian khong nhan,119000,119000,5,1,1
0,0,"Quan Jean Nam rach goi Snazzy chinh hang, quan bo nam xanh dang slimfit thoai mai",600000,600000,5,1,1
0,0,Quan Au Nam Re Dep Nhat 2021 (XS tai XUONG),89000,89000,5,1,2
0,0,Ao so mi ngan tay nam Owen Bach dan Bodyfit hoa tiet caro - BA22690NT,568000,568000,5,1,2
0,0,Ao ni sweater Drew ao ni bong cotton unisex nam nu cao cap,178000,178000,5,2,3
0,0,"Ao Thun cho ca Nam va Nu Phan Quang In CA MAP , ao chat, di dem, di phuot bao ngau, nhin da mat",59000,59000,3.8,4,5
104000,62,QUAN SHORT KAKI HAHAMAN NAM CO GIAN CAO CAP LUNG THUN TANG KEM 1 VO  BTH01,169000,65000,4,1,8
0,0,Quan dui the thao nam thoi trang phong cach tre trung nang dong M5 - NOON.MEN,100000,100000,4,1,
91000,20,Ao len gile Aligro ALENGL010,455000,364000,5,2,5
0,0,Ao so mi nam dai tay TQQ MADE IN VIET NAM hang cong ty du mau tre trung,219000,219000,5,2,4
0,0,"quan jean nam soc trang,quan jean nam new style - Couple Tina",189000,189000,4,1,7
0,0,Quan Lot Nam  Thun Lanh – Sieu Mong – Sieu Thoang Mat. Xu Huong Noi Y Cua Canh May Rau,49000,49000,5,1,1
0,0,Quan Sip Nam Chu V Nang Mong Sieu Thoang K367 - Trang - L,62000,62000,0,0,10
0,0,AO KHOAC DU Cao Cap Hoat Hinh.,195000,195000,4,1,1
0,0,"Ao thun tay lo form rong STREETWEAR phong unisex nam nu, ao thun cotton100% phong cach streetstyle HINH IN KO TROC",189000,189000,5,1,1
0,0,Ao Oversize Neon - Ao thun tron form rong tay lo mau xanh neon cuc dep unisex,198000,198000,4,1,1
0,0,ao khoac nam trung nien  mua dong lot long  am cao cap ,450000,450000,4,7,25
0,0,"Quan The Thao Nam DONEXPRO Form Regular, Thiet Ke Om Nhe Gon Co 2 Tui, Vai Thun Thoang Mat, Co Gian Tot MSC-984",199000,199000,3.5,2,6
0,0,Ao gile unisex Wind form rong len Basic nam nu oversize kieu phong cach ulzzang,79000,79000,5,2,12
0,0,"Quan au tay nam vai co gian phom om ong con, hinh that",135000,135000,4.5,5,5
0,0,"Quan dui xuoc slimfit MK CLEVER, Form slimfit om gon, chat vai dui xuoc chong nhan, mac sieu thoang va mat - QDX04",195000,195000,5,1,2
81000,32,"Ao dui nam co tau mo khuy tay lo tre trung ArcticHunter, thoi trang thuong hieu chinh hang",250000,169000,4.3,9,10
0,0,Quan Jean Nam Chat Bo Cao Cap Quan Bo Nam Ong Con Rach Xuoc Cao Cap Co Gian GH55,149684,149684,1,2,
0,0, Bo Dui Coc Nam chat lieu dui cao cap Ngon - Bo - Re nhat thi truong dui atb.shop 2020,169000,169000,5,1,2
34000,17,[KIM VANG] Ao bep dong phuc tay ngan chat lieu Kaki thun thoang mat- Mau xanh den mau 01,204000,170000,5,1,1
0,0,Quan Lot Nam Quan Sip Nam Chat Cotton Mem Min Co Dan 4 Chieu - Chon Mau ngau Nhien,24000,24000,4,1,3
0,0,Quan Jean Nam Streetwear Cao Cap FNOS NZ15 Mau Xam Xuoc - Form Slimfit - Jean Thun Co Gian.,550000,550000,5,1,2
0,0,"Hop 6 chiec Quan lot nam thun lanh nhat ban QMEN, quan boxer nam khong duong may khong vien",224000,224000,0,0,
0,0,Quan bo ngo nam trung nien tui cheo chat co gian dep co den size 36,249000,249000,1,1,2
0,0,Ao thun nam Ao phong nam co co TT01 Chat thun dep chuan shop,125000,125000,3,2,2
0,0,Ao thun nam the thao,99500,99500,5,1,1
0,0,"AO KHOAC DU BOMBER TUI HOP SIEU NGAU CHO CAC BAN NAM,THIET KE HOA TIET MAU SAC SINH DONG 1HIT1 FASHION",98000,98000,5,2,3
0,0,"COMBO 4 quan lot nam boxer hat mat xa cao cap, quan sip nam co dan 4 chieu khu mui khang khuan",199000,199000,5,1,2
0,0,Hang cao cap | Bo vest nam mau xanh den cuc sang trong - DUKI STORE,849000,849000,5,2,3
0,0,QUAN SHORT VULCANO 1033,372000,372000,4,1,2
0,0,AO THUN NAM  DAI TAY CO TIM PHOI NUT CUC DEP,149000,149000,3,2,5
0,0,"Ao thun POLO Nam tron co tru Han Quoc,thun cao cap from chuan, thiet ke phong cach sang trong- ao thun polo nam",159000,159000,5,1,
0,0,"Ao thun Polo nam co be vai ca sau Cotton tre trung ️ Hang VNXK ️chuan form,sang trong-lich lam",159000,159000,4,1,
0,0,"Quan short nam MK Clever, chat lieu poly gio the thao mac nhe va thoang mat phong cach tre trung ca tinh - AT01",149000,149000,4.2,5,10
0,0,Ao Thun Nam Co Be Ngan Tay XV02 Thoi Trang Top Fashion Shop Chat Vai Mem Min Phong Cach Han Quoc,125000,125000,5,1,1
0,0,(SIEU DOC) Ao Thun Roronoa Zoro One Piece Cuc Chat  Ao Zoro Dao Hai Tac Dep OP153,79000,79000,5,1,1
0,0,Ao khoac jean nam Unisex thoi trang cao cap form tron don gian dam chat - Hot New 2021,148800,148800,4.5,2,2
0,0,COMBO 6 QUAN SIP DUC TAM GIAC ,239000,239000,5,1,3
0,0,"Ao so mi LB, caro dai tay , phom body , mau xam SMVS254",150000,150000,1,1,
0,0,Ao Thun Tay Lo Freesize Nam Nu 40-70kg,39000,39000,5,2,2
0,0,Quàn short nam thẻ thao thuong hiẹu TORANO BW072,199000,199000,4.3,4,6
0,0,Quan Jean Nam dep ️️ Quan jean nam cao cap co gian phoi bo chan bo lung mau moi 2021 To To Shop - JN74,169000,169000,4.6,5,8
0,0,Combo 2 quàn dùi - Cotton co giãn 4 chièu,89000,89000,5,1,4
0,0,"Ao Thun Phan Quang 7 mau  co khac chu ""Xin dung the hien o day"" phong rong hoa tiet sieu hot, trang den nhin bao chat",59000,59000,3.2,5,15
0,0,"Quan jean nam LB co gian cao nhe, phom body, DNHQ8765",299000,299000,3,2,3
120000,43,"Ao thun polo nam Lados - 9059 Chat vai ca sau poly kho thoang , co gian tot",279000,159000,5,2,2
0,0,Combo 3 Quan Lot Nam JME JM079 (Free Size),199000,199000,4,4,43
0,0,AO KHOAC NAM CO KHOA KEO,189000,189000,5,4,12
0,0,(Hang Xuat Xin) Bo Dui Nam ( Mat - Nhe Nhu Khong),198000,198000,5,7,20
36000,31,[ Co Anh That ] Ao thun unisex tay lo form rong - Nam chu meo,115000,79000,4.6,7,15
86000,30,"Ao thun nam co be vai ca sau, Combo 2 ao – EZ210",285000,199000,4.2,25,51
50000,8,Ao khoac da nam dang lung co vest NAD94,610000,560000,4.5,4,9
50000,22,"Ao so mi nam dai tay co tau khuy mo form rong chat dui mem mat, thoi trang xuan he 2021",229000,179000,4.1,17,50
0,0,"Hang Nhat - Combo 2 ao ba lo nam khang khuan soi cotton mem min sieu thoang mat, tham hut mo hoi tot",165000,165000,4.5,2,14
186000,50,"Ao thun nam dai tay Aristino, chat lieu mem mai, ben mau, diem nhan cua ao nam o chu ky lon cach dieu tu logo Aristino duoc in o phan nguc phai. ALT002W9",375000,189000,5,1,1
40000,17,"Ao len cao co nam cuc chat LAHstore, len det to ong sanh dieu, thoi trang tre, phong cach Han Quoc",239000,199000,4,23,51
40000,8,"Ao khoac da nam cong so LAHstore, thiet ke dang dai lich lam, thoi trang tre, phong cach Han Quoc",530000,490000,3.9,28,66
124000,50,Quan jogger kaki tui hop phoi day co gian ( 45 - 85 kg ),250000,126000,5,2,9
0,0,Ao khoac jean nam A85 xanh tron,230000,230000,4.7,3,8
40000,11,"Ao khoac len nam co tru tran bong ArcticHunter, thoi trang tre, phong cach Han Quoc, thuong hieu chinh hang",365000,325000,5,3,11
144000,44,"Quan Sot Jean nam co dan 4 chieu Thuong Hieu Chandi, phong cach han quoc mau moi nhat 2021 HD208",324000,180000,4.8,40,61
0,0,"Ao Thun Nam Phan Quang In hinh NGUA MOT SUNG , ao chat, di dem, di phuot bao ngau, nhin da mat",60000,60000,4,6,14
90000,38,Ao so mi nam caro cao cap dai tay SM091,239000,149000,5,3,8
80000,20,"Ao khoac cardigan len nam muoi tieu co tru 2 lop ArcticHunter, thoi trang thuong hieu chinh hang - Xanh",400000,320000,3,2,8
0,0,"AO KHOAC DU NAM CUC CHAT , CO MU CHE ",79000,79000,1,1,5
0,0,"Ao Ni Hoodie Travis Scott, Hoodie Nam Nu Form Rong Unisex, chat ni bong - Beshine Store",180000,180000,5,2,4
0,0,Ao len co 3 phan nam trung nien thu dong 2021,150000,150000,5,1,2
0,0,Ao Hoodie Teelab Rainbow HD041,500000,500000,5,2,7
79200,44,Ao Thun Nam Ngan tay Khong Co Vai Cotton Co Gian 4 Chieu Mau Sac Da Dang MEN LUXURY AT1,178200,99000,5,5,13
0,0,"AO KHOAC DU NAM BOMBER UNISEX MAU SAC SINH DONG,KIEU DANG SANG TRONG THOI TRANG MOI KME",97000,97000,2.5,2,4
0,0,Combo Ao khoac + Mu Ao khoac mau vang doi tuyen Heavy Free Fire tang 1 non luoi chai mau vang theu cao cap cuc chat du size cho ca nam va nu,169000,169000,4.8,9,27
0,0,Quan Short Nam Lung Thun Phoi Mau,55000,55000,5,1,
0,0,Quan Short Jeans Nam TD02,86000,86000,5,1,6
0,0,Quan Sot Kaki Nam M1,69000,69000,4,15,38
0,0,Quan Shorts Kaki nam lung thun,71000,71000,4.6,10,15
28000,50,Ao lot nam cotton trang sieu dep,56000,28000,3.7,3,19
0,0,[MAU AO HOT TREND 2020] AO THUN UNISEX NAM NU form rong tay lo - Free size 40-70kg -Danh cho ca Nam va Nu,52000,52000,3.8,4,14
0,0,Bo 5 Quan Lot Nam Nhat Cao Cap (Giao Mau Ngau Nhien),130000,130000,0,0,4
0,0,Ao khoac hoodie nam 4YOUNG phong cach Han Quoc Cau Vong,59000,59000,4,1,23
0,0,Quan lot nam khong vien may sieu mong tui loi thoai mai -,97500,97500,4.6,7,20
0,0,Quan Jogger Nam Tui Hop Chat Dui So Go ( Soi ) ROUGH OUTFIT,170000,170000,4.3,14,25
0,0,Ao chong nang nam thong hoi ao khoac nam chong nang chong tia UV thoang mat mau nam tinh,65000,65000,4.5,25,70
0,0,"Ao thun 3 LO nam, cotton mem min",70000,70000,4,1,9
0,0,Combo 5 Quan Sip Tam Giac - Quan Lot Nam,132000,132000,0,0,3
0,0,Combo 03 quan ship tam giac thong hoi,54500,54500,5,1,1
140000,50,Ao chong nang danh cho nam,280000,140000,3.7,3,14
0,0, Quan Jogger Lot Ni Nam Nu Kieu Dang The Thao,59000,59000,5,1,6
65000,46,"Ao chong nang NAM thong hoi sieu mat, chat lieu thong hoi",140000,75000,5,1,2
0,0,"Quan au nam cao cap co gian 4 chieu cao cap dang slimfit, chuan thiet ke han quoc, cuc ton dang, lich su, tre trung",234000,234000,5,1,1
0,0,QUAN LOT KHE LINH SEXY QK71,110000,110000,4,1,1
0,0,QUAN LOT TAM GIAC DOC LA ,100000,100000,5,1,3
9000,10,QUAN LOT BIKINI NAM THUN COTTON QSHOP QB0048,90000,81000,4.8,4,11
0,0,BO DO PIJAMA NAM CAO CAP QSHOP QM194,320000,320000,5,2,4
0,0,Ao Khoac Nam Ao Khoac Du Day Nam Tron Lot Du Cao Cap AK54,139000,139000,3.8,4,6
0,0,"Quan Jean dai Nam Cao Cap Ong suong 03 mau co ban, form chuan dep size tu 50-90kg",255000,255000,3,2,7
99000,42,Ao chong nang nam THE 1992 Ao khoac chong nang vai xuoc cao cap,238000,139000,5,1,6
0,0,QUAN JEAN NAM RACH 01,139000,139000,3.7,3,6
0,0,hop 4 chiec quan lot dui nam boxer 100% cotton co dan sieu dep,88000,88000,1,1,2
0,0,"Quan Jogger Nam Nu phoi soc, hoa tiet cuc ca tinh co Big Size",68000,68000,4.7,29,66
0,0,Ao khoac so mi nam nu co non,84000,84000,5,5,14
59500,10,OWEN - Quan kaki nam Owen chat tho giay mem mai co dan mau den 21993/22006,595000,535500,0,0,2
0,0,Ao khoac so mi soc caro,95000,95000,5,8,21
55000,37,Ao So Mi Nam Caro Phoi Non Phong Cach Tre TKPCB30,150000,95000,5,1,6
0,0,"Do bo nam mac nha dao pho chat thun lanh in chu TGTW doc than de thuong, ca tinh nang dong",100000,100000,5,1,2
78000,50,Ao phong nam tay lo vai thun cotton co gian phat sang chat mem min y anh,156000,78000,1,1,2
0,0,"<FREE SHIP> Ao khoac du nam nu kieu bomber (GJ) vai 2 lop chat xin, day dan, y anh",95000,95000,3.5,2,7
0,0,Ao Khoac Du FASHION 2 Lop In 7ZIA Chong Nang Tranh Mua Cho Nam Va Nu,99000,99000,5,1,3
0,0,"QUAN JOGGER NAM NU K1 VAI KAKI CO GIAN, KHOA ZIP CA TINH",86000,86000,0,0,
0,0,"AO KHOAC DU , AO KHOAC DU BOMBER NAM NU CUC DEP PHONG CACH HAN QUOC ",93000,93000,4,1,2
0,0,Quan short poly phoi lung co gian 4 chieu mem min,76000,76000,0,0,
0,0,"Quan Caro thun Nam Nu unisex - quan dai soc caro mau xanh den ong suong tre trung, ca tinh",96000,96000,0,0,1
0,0,AO KHOAC NHUNG BOMBER UNISEX NAM NU THOI TRANG LANO STORE 99,153000,153000,1,1,1
0,0,Bo Quan Ao Nam The Thao Coc Tay Hoa Van,98000,98000,4.5,42,255
0,0,Ao Khoac Hoodie Nam DH 110,69000,69000,4.6,17,62
0,0,AO KHOAC KAKI NAM THOI TRANG PHONG CACH SIEU HOT STT B49,149000,149000,1,2,4
0,0,Ao khoac jean nam ca tinh tre trung - NH Shop,199000,199000,3,2,8
0,0,"Ao Khoac Bomber Du GJ Kieu Moi Thoi Trang Sieu Chat, AO KHOAC DU NAM NU 2 LOP BOMBER HOA TIET CHU GJ KEM NUT CAI TIEN LOI THOAI MAI, ao khoac du bomber nam nu nut cai logo phong cach bong chay thoi thuong",95000,95000,4.5,2,5
0,0,"Ao Khoac Nu (Nam) Nhung Gan BOMBER Thoi Trang Cao Cap Sieu Xinh Mau Hot Trend, Ao Khoac Nhung Theu Logo Kieu BomBer, Kieu Dang Cuc Teen, phong Cach Hien Dai Hot, Ao Khoac Bomber Nhung tam DEEP END Unisex Form Rong 2 mau xanh/hong kem anh/video",179000,179000,4.5,2,7
0,0,Ao Bomber Jackets/ Ao Khoac Nhung Gan Theu Logo 2000 Cuc Bam Unisex Nam Nu Form Rong Ulzzang,137000,137000,0,0,
73000,30,Quan Dui Nam TSIMPLE Nhieu mau,242000,169000,4.3,3,8
0,0,Ao Khoac Du Chong Danh Cho Nam Nu Co 2 Mau Jacket Form Rong In Hinh Angle Land Doi Unisex,105000,105000,4,2,10
0,0,Quan Jogger Kaki Nam Tui Hop Mau Xanh,125000,125000,3,3,6
0,0, Ao khoac du cardigan unisex form rong Mat Cuoi nam nu ulzzang Wind,130000,130000,4,1,3
0,0,Ao Sweater Ni Tron Nam Nu Phom Rong,95000,95000,5,1,1
0,0,"SET DO BO MAC NHA NAM NU UNISEX THUN LANH COTTON MAT ME THAM HUT TOT, CO GIAN PHONG CACH NANG DONG THE THAO - THOI TRANG MUA HE,DO BO MAC NHA NAM - JINS STORE",93000,93000,4,1,2
0,0,"DO BO THE THAO NAM NGAN THUN  COTTON 4 CHIEU CO GIAN TOT,QUAN PHOI 3 SOC DEP,DO BO THE THAO MUA HE CA TINH - JINS STORE",88000,88000,4,1,1
0,0,Quan Dai The Thao Nam Ong Bo 3 Soc,71000,71000,3,1,
118000,0,Ao thun nam ma TT56.0 kieu dang Ao tay lo nam form rong the thao coc tay dep cho mua he vai cotton,0,98000,4.3,39,
0,0,"Ao khoac du, Ao khoac du nam , ao khoac gio nam , ao bomber du 2 lop, Ao khoac du nam nu mac / ao khoac gio nam nu mac / ao khoac du kieu bomber / ao khoac cap doi / ao khoac form rong",100000,100000,5,1,1
0,0,"Quan jogger nam tui hop chat kaki mem min, phong cach duong pho RFE",115000,115000,4.5,2,5
0,0,"Quan jogger thun soc Caro Nam Nu unisex - quan dai soc caro mau xanh den ong suong tre trung, ca tinh",100000,100000,0,0,
0,0,"Ao Hoodie Non Chui Trum Dau Nu Nam Unisex Chat Vai Ni Bong PE Day Min Hinh Toan Hoc Reasons, Ao hoodie unisex khoac ni bong chui dau nu non 2 lop day dan chat luong, Ao Ni Hoodie Nu Nam Unisex ulzzang from rong",89000,89000,4,2,
0,0, AO HOODIE  (BigSize),92000,92000,5,1,1
0,0,"Quan tay nam cao cap BIG SIZE 45kg - 110kg , ti mi tung duong kim mui chi - NH Shop",319000,319000,4,1,3
0,0,"Ao thun nam nu chat cotton 4 chieu da quang in hinh con ca mau tuoi tre phong cach ca tinh,AO THUN NAM NU IN HINH RICK CA TINH COTTON CO GIAN 4 CHIEU",95000,95000,4,1,3
0,0,"Ao khoac du nam nu unisex kieu bomber form rong, 2 lop day dan",95000,95000,0,0,
0,0,"Do bo the thao nam tap gym,mac o nha di choi cuc thoang mat, tham hut mo hoi tot thoi trang",99000,99000,5,4,14
91000,36,Ao khoac du gio nam chong nang thoai mai TKAKD901 PigoFashion nhieu mau,250000,159000,4.5,2,6
0,0,Ao gile nam,0,300000,3.8,15,
0,0,Ao Khoat Jean Nam Cao Cap mau xanh MS2087,180000,180000,0,0,6
0,0,Ao so mi nam tron cao cap mem min tham hut mo hoi LAVIC-5231,92000,92000,4.6,38,97
0,0,Ao Polo thun nam lon tuoi co tui️ Hang Dep  ️Ao thun nam trung nien co tui ( chat lieu cotton 100%),159000,159000,5,1,7
0,0,"Ao bo nam dai tay cai nut, Ao khoac bo nam - jean nam 2 mau (xanh-den) - thoi trang - phong cach - thu dong 2022 AJ080",210000,210000,1,1,2
90000,24,"Quan tay nam ong con Amazing, dang tre om gon, nhieu mau nam tinh, chat lieu co gian, phong cach Han Quoc, tre trung, nang dong",379000,289000,4,1,8
0,0,Quan shorts Nam sieu mong vai du - A029,190000,190000,4.8,6,16
0,0,"Ao thun nam phong tron Casual 1st co tron tay ngan coc, vai 100% cotton cao cap thoang mat, tham hut mo hoi, form ao tre trung thich hop di lam, di choi, dao pho, du lich, Made in Vietnam - TheFutureIsBright",250000,250000,4,1,4
0,0,"AO KHOAC NI HODDIES CHUI DAU DANH CHO CAC BAN NAM NU TRE , SIEU XINH PHONG CACH HOA TIET MOI THOI TRANG LANO STORE",97000,97000,0,0,
0,0,SET BO DO THE THAO PHONG CACH MOI CUC CHAT DANH CHO ANH EM THOI TRANG MOI KINGSHOP79,79000,79000,5,1,2
0,0,"SET BO THUN HE NAM,THIET KE SIEU NGAU,CHAT LIEU VAI THOANG MAT THOI TRANG KING STORE",79000,79000,4,1,1
0,0,"AO SO MI NAM DAI TAY , CARO CUC CHAT , DANH CHO GIOI TRE",99000,99000,0,0,
0,0,Ao So Mi Nam Soc Caro Phong Cach Han Quoc GOAT MENSWEAR,82000,82000,4.1,15,30
0,0,"AO KHOAC DU BOMBER NAM,THIET KE HOA TIET HINH VA CHU SIEU NGAU",97000,97000,0,0,4
0,0,"Quan Sot Nam chat jean King168 , Quan Short Jean Nam cao cap NT516",0,149400,1,1,
0,0,"Ao khoac kaki cao cap nam KIng168 , ao khoac 2 lop thoi trang nam MA01",0,149000,5,1,
0,0,"Quan short nam chat jean King168 , co dan , ngang dau goi tren Mau TB06",0,150000,5,1,
0,0,"Ao thun nam mau xam co be King168 , ao phong thoi trang nam MS507",0,100000,3,1,
0,0,"Ao Thun tay ngan co be cao cap nam King168 , Ao Thun Polo nam thoi trang cao cap ATNCT36",0,99000,4.5,2,
0,0,"Quan Jogger Loai Xin Thoi Trang Nam , Quan Kaki Thiet Ke Nang Dong Cao Cap Nam NT133",0,159000,5,2,
0,0,ao hoodie nam unisex from rong HD2B6,75000,75000,5,5,18
0,0,"Ao One Piece Luffy ATT-01, Ao thun Anime Manga One Piece Monkey D. Luffy Unisex Nam Nu",28650,28650,5,8,17
0,0,Quan Jean Nam Nu Baggy Unisex Ong Rong Phong Cach Tre Trung,0,178000,4.5,6,
0,0,quan dui nam mac o nha quan dui nam ngan QDUP nhieu mau,40000,40000,5,2,16
80000,42,Ao sweater nam nu form rong Unisex mot mau in hinh ca tinh Han Quoc – FORMEN SHOP – FMGV038,189000,109000,4.3,12,22
30000,15,"Ao Polo nam co be ngan tay, chat lieu cao cap, thoang mat, ben mau, thiet ke tre trung – FORMEN SHOP – FMPS143",199000,169000,4.5,32,55
80000,44,"Ao thun nam co be tay ngan tre trung, chat lieu cotton cao cap mau THUU66",180000,100000,4,67,174
81000,41,Ao so mi nam caro cao cap ngan tay NT212,200000,119000,4.1,30,117
116000,39,Quan jean co gian q104 om body Muidoi,300000,184000,4.5,7,21
0,0,Do bo the thao nam vai thun tuyet mua mem min. Bo PIKACHU- Thoi Trang Phong Cach Han aloha style (Freesize tu 45-70kg)-Nhieu kieu lua chon,99000,99000,4.5,26,47
0,0,Quan Kaki Nam Dep Dang Han Lung Thun Tien Dung Form Slim Fit Cuc Dep QK045,109000,109000,4.8,4,8
120000,46,Ao khoac du lot long Hahaman cao cap giu am AKDL041,259000,139000,4,7,14
0,0,Ao khoac hoodie | Ao khoac ni 3 chu meo xinh xan -Bao Bao store,69000,69000,4.8,18,96
111200,44,Quan short jean nam co dan kieu dan tre trung don gian theu hoa tiet Julido thoi trang han quoc THU20,250200,139000,4.7,26,53
40000,23,Quan Dui Ngu Nam,175000,135000,3,2,6
127200,44,"Quan jean nam mau xanh co hoa tiet dep hang moi ve, dan dau xu huong da co mat tai Julido Store mau moi MA26",286200,159000,4.2,22,38
0,0,"Ao so mi nam Coc Tay Tim Nhat dang body Han Quoc khong nhan, Ao so mi nam Ngan Tay Tim Nhat",79000,79000,4.7,3,5
0,0,Ao sad boiz ripped signature long sleeve Ao thun tay dai sadboiz RIPPED SIGNATURE,140000,140000,5,3,13
30000,25,QUAN NGU LUOI QC07,120000,90000,5,5,28
0,0,Ao Sweater Tay Dai Co Tron Phoi Long Day Dan Am Ap Cho Nam nu - kem anh that luon do -A6,225200,225200,5,1,2
49000,21,Ao kaki nam THE 1992 So mi dai tay,238000,189000,4.5,5,16
61000,34,Ao so mi nam THE 1992 Ao dui nam co be coc tay,180000,119000,4.8,5,13
0,0,Ao thun Nam Nu unisex ASALA  (ux-901),59000,59000,4.1,133,875
144000,44,"Quan Sot Jean nam co dan 4 chieu Thuong Hieu Chandi, phong cach han quoc mau moi nhat 2021 MR8002",324000,180000,5,20,24
0,0,"Ao khoac gio nam Goking, ngoai vai du, trong lot luoi. 3 tui tien dung.",225000,225000,4.8,5,11
0,0,Quan Short Jean Nam Chat Bo Co Gian️️Quan Dui Nam thoi trang cao cap (kem hinh that) To To Shop - QSJNM237,129000,129000,5,2,5
0,0,Combo 3 ao thun tron nam thoi trang VHL mau trang den xam,114000,114000,4.6,7,23
111200,44,Ao khoac nam 3D 2 lop du in nhiet khong bong choc co day rut hong mau moi nhat 2020 KHOAT K1A,250200,139000,4.8,12,32
26000,10,Combo 3 Chiec Quan Lot Nam Tam Giac Aristino ABF16-15,255000,229000,4.7,3,13
34200,30,Quan lot nam Hunk kangaroo Trunk go soi Uc - H02 - Xanh go thong,114000,79800,4.7,46,268
0,0,(SALE SOC) Ao thun AMD RYZEN danh cho cac progammer,139000,139000,4.7,3,4
42000,49,"AO THUN UNISEX TAY LO PHOM RONG NAM NU Hot Trend 2020- AO UNCOVER- Free size 40-75kg - Chat lieu vai tham hut tot, thoai mai van dong-aloha style",85000,43000,5,1,1
0,0,"Ao khoac du unisex Glean Mark 2 local brand ONTOP, ao khoac ONTOP Jacket Logo Fire - Ao khoac Logo Fire .Hang quang chau, Ao khoac du unisex Logo Fire local brand ONTOP, ao khoac streetwear ulzzang han quoc co non ca tinh",95000,95000,5,2,3
0,0,Bo Lao Dong Ran Ri Tui Hop Day Ran,120000,120000,3.5,2,2
0,0,Bo Lao Dong Bao Ho Lao Dong Mau Ghi Dam Day Ran,110500,110500,5,1,4
0,0,Ao Mang To Kaki Nam Dang Dai Ao Khoac Nam Kaki Dang Dai Sans20 Sans Shop,0,1090000,4,1,
0,0,Ao Khoac Hoddies Co Mu sieu sieu dep ,79000,79000,1,1,2
0,0,Ao khoac nhung bomber unisex nam nu hoa tiet cuc dep ,169000,169000,5,1,1
0,0,Ao Khoac Da Nam Dang Ngan Ao Da Nam Han Quoc Dang Vua Sans Shop Sans08,0,529000,4.8,4,
0,0,Ao So Mi Nam Ngan Tay Mau GE654 Thoi Trang Nam Cong So Chat Vai Mem Min Chuan Form,135000,135000,3.4,5,7
0,0,Quan sip quan lot nam thun lanh chim co hoa la cao cap sieu nhe,32000,32000,5,7,28
0,0,Ao so mi nam cao cap cham bi,149000,149000,5,2,2
141000,44,Ao So Mi Nam Nu Ke Soc Dai Tay Phong Cach Han Quoc Chat Cuc Dep Form Rong Thoi Trang,320000,179000,5,1,2
181000,45,Ao ni Hoodie vai da ca tron THE 1992 3 mau,400000,219000,4.5,2,2
0,0,Ao hoodie ni unisex speed City Cycle - ao ni sweater unisex form rong Local Brand,239000,239000,5,4,4
0,0,Ao Thun Unisex Bad Rabbit VACATION 100% Cotton - Local Brand Chinh Hang,350000,350000,4.5,2,2
0,0,Ao Bomber Jacket/ Ao Khoac Du 2 Lop Style Bong Chay in Bmoody Unisex Nam Nu Couple Hot Trend,95000,95000,5,1,3
0,0,Ao Thun Nam Den Tron THUNDEN01,59000,59000,0,0,
0,0,"Quan baggy nam cap cao ong rong vai Han cao cap, co gian phan loai tay au lich lam",199000,199000,4.7,3,6
0,0,"Ao chong nang Dap Van Nam, ao cam chac tay, day dan, bao ve da vao nhung ngay troi nang nong",87000,87000,3,2,6
0,0,Ao Thun Nam Co Co Phoi Mau FTM322 Thoi Trang ,150000,150000,4.5,24,62
0,0,Ao So Mi Nam In Chu Tra Sua,135000,135000,5,1,1
0,0,Ao Khoac Du Bomber Jacket - Ao Khoac Bong Chay Unisex Nam Nu GONZ Form Rong Ulzzang KUN,95000,95000,5,1,1
150000,31,Ao Thun Polo Nam Trung Nien Tay Ngan Det Kim 181 Cao Cap Viet Phap,479000,329000,5,1,1
150000,38,[MUA 1 TANG 1] Ao Thun Milan Nam Trung Nien Tay Ngan Co Co Cao Cap 108618 Viet Phap,400000,250000,5,1,1
186000,37,"AO KHOAC PHAO, AO LONG VU, AO KHOAC LONG VU - AO KHOAC NAM TRAN BONG SIEU NHE",500000,314000,4.7,9,14
0,0,"Ao Khoac Hoodie ESSENTIALS phan quang Nam nu, Ao ni hoodie ESSENTIALS nam nu fom rong unisex chat ni bong mem min khong xu long hinh in cao su noi SC",120000,120000,3.3,3,4
0,0,Bo The Thao Nam Bo Thu Dong Nam Chat Ni Da Ca Day Dan Cao Cap Form The Thao Tre Trung Nang Dong ,240000,240000,0,0,
0,0,Ao thun nam logo W phong tron thiet ke cao cap - TATCS035,129000,129000,4,1,2
0,0,QUAN JOGGER CHOLIE_ QLTD 0018,310000,310000,5,1,1
0,0,"Ao Ba Lo Nam Tanktop W&W Sieu Mat, Tham Hut Mo Hoi, Co Gian Tot Dung Tap Gym, Chay Bo, The Duc The Thao Cho Nam WTT13",157000,157000,5,1,1
111000,29,"Combo 2 quan short nam the thao thun lanh cao cap thoai mai, nang dong, tre trung - FORMEN SHOP - FMCB2PS090",380000,269000,4.5,45,181
20000,20,Quan The Duc Nam Phoi 3 Soc Ong suong Phong Cach The Thao,100000,80000,5,1,3
61000,31,"Ao Polo nam co be ngan tay, chat lieu vai ca sau cotton cao cap, tre trung, nang dong – FORMEN SHOP – FMPS041",200000,139000,4.3,7,22
51000,24,"Ao Polo nam co be ngan tay, chat lieu vai ca sau cotton cao cap, tre trung, nang dong – FORMEN SHOP – FMPS110",210000,159000,5,7,12
0,0,Quan Jean Nam Dang Slim Fit Den Dang Suong Ong Dung Han Quoc Nhuom Indigo Vai Denim Co Gian 4 chieu Hang Viet Nam Xuat Khau,550000,550000,5,1,1
0,0,"Quan kaki nam tu 60kg den BIG SIZE 90kg, chat kaki CO GIAN NHE, ong dung gon nguoi - NH Shop",159000,159000,4,5,13
0,0,"Ao Phong Nam, Ao Thun Nam Cao Cap, Sieu Dep M.O.N Boutique TR01",125000,125000,4,1,2
0,0,Ao Khoac Hoodie Mau Trang Hinh Do Among Us Chat Ni Mem Min Danh Cho Ca Nam Va Nu,155000,155000,4.1,14,30
10000,11,"Ao Khoac nam nu King168 , Ao Khoac Du nam nu cao cap NT629",95000,85000,4,1,2
0,0,SET 03 Ao thun 3 lo nam mac nha ,69000,69000,1,1,5
0,0,"quan jogger thu dong nam big size kieu dang Han quoc, phong cach rong big size",389000,389000,5,2,3
0,0,Ao Thun Lanh The Thao Co Dan 4 Chieu (ATL 020),230000,230000,5,1,1
0,0,"Bo The Thao Nam Thu Dong W&W Co Tron Chat Lieu Cao Cap Giu Nhiet Tot, Thiet Ke Nang Dong WHW06",855000,855000,5,1,2
40000,32,"Ao Khoac nam nu King168 , Ao Khoac Du nam nu cao cap NT603",125000,85000,5,1,11
0,0,"Ao Thun Tay Dai Nam Nu Form Rong Co Tron Du 5 Mau Basic Den, Trang, Xanh, Hong Chat Phong Cao Cap Unisex GUF",70000,70000,5,6,18
0,0,Quan Nam Rut Gau Hoa Tiet Ke Caro Phong Cach Tre Trung Thoi Trang Zenkonu QUAN NAM 1000086,79000,79000,5,1,2
0,0,Ao So Mi Nam Dai Tay Tron Co Ve Co Hoa Tiet Chu Truoc Nguc Hot Trend 2020 Thoi Trang Zenkonu SO MI NAM 1000022,89000,89000,1,3,3
91000,48,"Quan short nam GUZADO, Chat vai gio mem, Co gian Cuc Tot, Van Dong The Duc The Thao Thoai Mai GSR02",190000,99000,5,1,5
0,0,AO LONG NAM NU SIEU AM CHO MUA DONG YEU THUONG,178000,178000,5,2,4
51000,46,"Quan NAM 3 SOC chat vai cao cap co gian nhe, ong suong",110000,59000,3,2,9
0,0,Ao thun co be polo cao cap vai thun cotton sieu co dan hang chuan shop Phuongnamshop20 kve22,86400,86400,5,2,3
0,0,"Ao So Mi Nam Dai Tay In 3D Mau GQ02 Chat Vai Dep, Thoang Mat, Tao Cam Giac Thoai Mai Khi Mac",145000,145000,4.5,2,4
0,0,Ao thun Bad Habits Cracken Nguoi May Nam Nu - Ao thun tay lo vai cotton xin,290000,290000,1,1,4
0,0,"Ao Polo Nam Soc Ngang Trung Nien Co Tui Xuat Xin, from chuan- Hang Loai 1",159000,159000,5,1,5
0,0,Ao ni co mu danh cho nam Tokyo Revenger mau moi,189000,189000,5,1,2
0,0,Ao Khoac Du Nam ARTIST CLUB,73800,73800,0,0,
82000,50,Do bo thun lanh nam vai day dan co gian tot,164000,82000,3.4,5,11
0,0,Quan Jean Nam Cao Cap 12,99000,99000,4.2,5,12
0,0,Jean den rach goi,175000,175000,5,1,1
0,0,Ao thun nam tay lo form rong in hinh Naruto cuc chat,47000,47000,4.1,11,25
0,0,Bọ Di Chùa Cho Nam -  La Hán Nau,194000,194000,4.5,2,4
0,0,AO HOODIE - AO KHOAC NI NGOAI Day full zip (Anh That) HOOIDE MOI THEU CHU R DE THUONG,79000,79000,0,0,
0,0,Ao Ba Lo The Thao Cuc Xin Nam IN Mat Cuoi,53000,53000,0,0,
0,0,"Ao Khoac Du Nam Nu, Ao Khoac Chong Nang in Hinh Khung Long Xinh Xinh.Tp TKT",87000,87000,1,1,4
0,0,AO THUN NAM CO TRU FOMR BODY MAU MOI NHIEU MAU NY KIEU CHEO,65000,65000,1,1,
0,0,Ao khoac nam Ao khoat nam gio du 2 lop chong nang mau so 5 hang bao chat cuc chat hang dep,77000,77000,0,0,
0,0,Ao khoac phao nam co non logo theu cuc dep thoi trang nam am ap,155000,155000,1,1,5
0,0,Bo Quan Ao Nam Ao So Mi Nam Co Duc Quan Kaki Tron Zenkonu SO MI NAM 1000027 + QUAN NAM 1000060,139000,139000,4,2,4
0,0,Ao Thun Nam Tay Lo Co Tron Hoa Tiet Mau Loang Phong Cach Ca Tinh Thoi Trang Zenkonu TOP NAM 1000169,53100,53100,5,1,2
0,0,Quan short kaki 2V unisex form rong,85000,85000,5,1,
0,0,"Quan au nam den ong con cao cap,quan tay nam vai day dan khong nhan khong xu tre trung, dang om nang dong - Mau den - Size 31",85000,85000,0,0,8
111200,44,Quan short jean nam B888 co dan kieu dan tre trung don gian theu hoa tiet Julido thoi trang han quoc,250200,139000,4.5,43,87
0,0,Ao so mi nam May 10 loai dai tay ke soc 8724#383,156000,156000,5,1,15
0,0,Ao quat dieu hoa theo cong nghe Nhat Ban,910000,910000,0,0,
0,0,"Quan Tay Au Nam Batuni Mau Be Hang Thiet Ke Form Sieu Dep, Sieu Ton Dang QN4",550000,550000,5,2,2
10000,8,Ao Thun Nas Daily Mau Moi,119000,109000,4,13,130
10000,5,Ao Hoodie Missout Co Day Keo Cao Cap,189000,179000,4.2,9,50
10000,9,Ao Thun SWE Mau Ao Thun Phan Quang Sieu Dep,109000,99000,4.5,58,188
0,0,Quan Sip dui thun lua in hinh giao mau ngau nhien,39000,39000,0,0,
137700,30,Ao Len Nam Phoi Mau Zigzag Couple TX MOS 1002,459000,321300,4,2,3
0,0,Bo 4 Quan Sip Dui Xuat Nhat Chat Lua Cao Cap (Giao mau ngau nhien),89000,89000,3.5,14,254
0,0,Ao khoac nam long cuu co mu thoi trang 2020 cuc dep - ao khoac nam lot long mu co the thao roi,485000,485000,4,21,40
169000,50,Quan The Thao Nam Ke Soc Chat Lieu Cao Cap Phong Cach Tre Trung ZERO,338000,169000,5,1,3
0,0,Quan Jean Nam Den Tron TS_JDen,99000,99000,5,3,14
0,0,"Ao khoac phao nam nu am. nhe, day dan co mu",255000,255000,0,0,
0,0,Do boi cho nam quan lung - XXL,299500,299500,5,1,53
0,0,QUAN AU NAM TRUNG NIEN ,142000,142000,3.8,4,9
0,0,Ao khoac du 3D loang trang den nam nu,120000,120000,4,1,
120000,45,"Quan short nam FWEAR chat kaki mem min, thoang mat, phong cach han quoc",269000,149000,5,8,24
0,0,Do Lam Di Chua#phap phuc Phat Tu-Mau Xeo Nhat Nam,162890,162890,5,1,1
0,0,Ao so mi viet tien dai tay mau nhot dam,350000,350000,5,3,11
0,0,Bo quan ao tap gym nam ket hop quan tap gym nam 2 lop va ao 3 lo thun lanh - Thun lanh cao cap ASRU,219000,219000,0,0,
61000,41,Quan Jogger ni nam THE 1992 the thao vai tron 3 mau,150000,89000,5,3,11
111200,44,"Ao khoac nam JJ02 XAM , khoac du nam 2 lop phoi non khong thao roi thoi trang han quoc tre trung cuon hut Julido mau TT01 chat lieu tham hut mo hoi day dan mac thoang mat",250200,139000,4.1,39,85
0,0,"Ao khoac gio bon mua,2 lop nam nu, co tui dung tien loi,chan gio, chong nuoc, chong bui, tranh nang",145000,145000,0,0,
0,0,AO KHOAC KAKI NAM PHOI MAU CAO CAP KHONG XU LONG,239000,239000,4.6,11,18
132500,50,Quan short lung thun nam Novelty 1910560,265000,132500,5,4,19
0,0, Ao so mi nam Novelty dai tay 170989D vat bau ,549000,549000,5,2,5
0,0,Quan dui nam the thao phoi soc 2 mau den trang chat thun poly day dan cao cap,109000,109000,3,2,5
0,0,Combo 2 Quan Lot Dui Nam Thong Hoi Nhat Ban,49000,49000,5,2,3
0,0,QUAN SHORT KAKI TUI HOP NAM,245700,245700,5,1,2
0,0,"XA HANG TON KHO QUAN SHORT KAKI NAM VAI DEP,  KHONG RA MAU",97500,97500,4,1,2
0,0,COMBO 6 QUAN DUI CON NAI MAC MAT,232700,232700,5,1,4
0,0,Ao khoac du nam co non AK0037,99000,99000,0,0,
0,0,Quan short nam MIKENCO Double tape short,500000,500000,5,2,2
0,0,Quan jean nam MIKENCO CRYSTAL JEANS,800000,800000,5,1,1
400000,25,Ao thun ngan tay co tron ADLV Baby Face White Mini Chocolate Donut Trang,1599000,1199000,5,1,1
0,0,Hop 4 Quan Lot Luoi Danh Cho Nam Thoang Khi Cao Cap ( Quan lot tam giac) ,119000,119000,2,1,7
65000,35,Combo 3 Quan dui nam mac nha mau ngau nhien CB03,185000,120000,2.3,3,27
0,0,Ao So Mi Nam WHATEVER Chat Lieu Kaki Fom Rong,99000,99000,4.7,7,15
0,0,Ao So Mi Nam Phong Cach Dieu Soc Tay Den,69000,69000,5,4,8
0,0,Ao So Mi Nam Tay Dai DOCKERS 69684-0040,1199000,1199000,1,1,1
174600,45,Ao so mi nam tay dai form slim om soc xanh Khatoco A1MD388S1-THSC039-2009-D,388000,213400,5,1,9
0,0,Ao so mi nam tay dai soc caro lua in 3D - TM331,135000,135000,1,1,2
0,0,Ao Thun Teelab Paint TS120,195000,195000,5,1,3
0,0,Ao khoac bong chay den chat vai day dan form rong unisex nam nu ,95000,95000,0,0,
0,0,Quan dui nam loai caro nho chat vai mem min co gian tot mac thoang mat de chiu free size duoi 65kg,29000,29000,4.3,10,59
0,0,Ao khoac phao nam kieu dang han quoc,255000,255000,4,92,191
0,0,Ao len nhung lot long cho nam,297000,297000,4,2,5
0,0,AO THUN NAM CO BE PHOI SOC,148000,148000,5,1,2
0,0,Ao thun nam co be soc ngang co tui ao,138000,138000,5,1,1
0,0,AO THUN NAM CO TRON SOC NGANG PHOI TUI,149000,149000,5,1,3
0,0,AO THUN NAM COTTON CO BE CAO CAP Y HINH,128000,128000,5,1,1
0,0,AO KHOAC LEN NAM 01,98000,98000,0,0,
0,0,AO KHOAC NAM CO NON CHONG NANG CAN GIO DI MUA CAO CAP PHONG CACH SANH DIEU THOI TRANG KIM GIA,105000,105000,0,0,
0,0,Ao khoac nam 3 lop chong tham nuoc lot ni tach biet,800000,800000,4.6,25,57
0,0,Quan 3 soc bo Nam Nu BIGSIZE,62000,62000,4.6,21,85
0,0,Ao thun nam co tron in noi con ca,179000,179000,5,2,3
0,0,BO DO NI NAM COTTON DAI DAY DAN CUC DEP,268000,268000,0,0,3
0,0,AO KHOAC LEN NAM MAC NGOAI NHE,158000,158000,5,1,
0,0,AO POLO IN SOC CAO CAP,259000,259000,5,1,2
0,0,QUAN JEAN BAGGY NAM BASIC DANG SUONG ONG RONG XANH DEN HANG CAO CAP CHUAN SHOP,0,149000,3.8,5,
0,0,SET Doi NAM NU-Bo PIJAMA NAM NU Style Han Quoc-COTTON 100%,420000,420000,5,1,1
0,0,AO POLO GIAU NUT CAO CAP,249000,249000,5,1,2
0,0,Ao so mi nam co tru cai het cuc mau xanh bien,149000,149000,3.3,3,12
0,0,"Ao khoac gio nam nu cao cap 2 lop, ao khoac du chong nang, chong gio, ngan tia UV",165000,165000,3.8,5,13
0,0,Ao Dai Tay Sweater Teelab Vietnam LS008,400000,400000,5,1,1
0,0,5 QUAN SIP THONG HOI TAM GIAC,150000,150000,0,0,
0,0,Ao so mi nam dai tay mau xanh navy,149000,149000,4,11,31
0,0,Quan the thao nam dai thun LOAI 1 chong UV di nang cuc thoai mai loai quan dai thun nam vai mat DN01,85000,85000,4.8,4,11
0,0,Ao so mi nam ngan tay caro cao cap cotton 100% rat min cuc mat loai ao so mi ngan tay caro vat bau ASST60,149000,149000,4.7,7,27
0,0,Quan tay ong con nam co dan vai cotton dep may ky loai quan tay nam hien dai tre trung,149000,149000,5,2,9
156000,55,"Ao Thun Nam Ngan Tay Co Tron (5APKH010XNG) Chat Lieu Cotton Cao Cap Tre Trung, Thoang Mat Chinh Hang Biman By BiLuxury",285000,129000,5,1,7
0,0,Set Bo Mac nha Gau Cap Doi Nam Nu HOT RE DEP Quan Dui Phoi Ao Thun Form Rong Tay Lo -Do Bo Thun Hoat Hinh sieu Cute,75000,75000,5,2,3
0,0,Blentino quan tay cotton nam Dd29593-8,485000,485000,3,2,4
206000,36,"Ao So Mi Nam Ngan Tay (4SMCC001CAD)   Hoa Tiet Caro Nang Dong, Phom  Bodyfit  Tre Trung,Thanh Lich, Chat Vai Cao Cap Thoang Mat,Mem Min Hang Chinh Hang BILUXURY",565000,359000,4.3,3,3
0,0,"Ao so mi nam dai tay co tru co tui truoc nguc, vai Dui co gian thoang mat, khong nhan TM1222 - TMSTORE",125000,125000,0,0,
0,0,"Bo 4 Quan Lot Nam Cao Cap (Danh Cho Cac Ban 50-85kg), Co Gian 4 Chieu Cuc Tot",99000,99000,3.9,14,53
350000,44,"Combo 2 ao thun nam 3 quan sip nam 5 doi tat nam Cao Cap MRM FASHION ( Den,Trang)",800000,450000,3.7,3,6
20000,16,Ao Thun Nam Cotton Co Tron Phoi Hinh Cao Cap ShopN6 - AT06 (Nhieu Mau),129000,109000,4.7,6,6
150000,30,Ao thun nam Ellesse Lentamente - 619304,500000,350000,5,1,2
0,0,Ao so mi nam dai tay ke soc xanh ,149000,149000,4,6,29
160000,37,Ao Khoac Da Nam Lot Long Simple Cao Cap KD06 ,435000,275000,4.8,6,21
0,0,Blentino ao so mi xanh dai tay BSD01(2),445000,445000,5,1,4
100000,0,so mi nam trung nien ngan tay vai lanh cuc mat form chuan dep ASLOG2,0,89000,5,3,
160000,37,"Ao Polo Nam,Ao Thun Nam Co Be Biluxury (5APCH007TRK ) Chat Vai Cao Cap, Kieu Dang  Tre Trung Lich Lam, Co Gian 4 Chieu, Chong Nhan,Thoang Mat  - Hang Cao Cap Chinh Hang Biluxury",429000,269000,5,2,4
0,0,Ao Hoodie Zip Tui Nam Nu - Vai Day,180000,180000,2,1,2
0,0,Ao So Mi Nam Dai Tay Kaki Theu Logo Phong Cach,49000,49000,5,4,21
0,0,Quan jogger thun nam the thao tui hop cao cap chat thoi trang - QUAN SM019C4,99000,99000,5,1,5
0,0,Bo thu dong the thao STYLE MARVEN ao khoac nhe trum dau mix quan jogger bo gau Han Quoc - SET NAM 90000131,139000,139000,4,2,7
0,0,Ao so mi nam co tru chui dau dai tay soc xanh dam,149000,149000,4.8,4,11
70000,10,"Ao Khoac Nam Bomber Biluxury Khang Khuan,Chat Vai Gio Du Cao Cap, Form Dep ,Chong Nuoc ,Di Mua Nhe,Co Gian Giu Nhiet Tot,Nhieu Mau Sac De Dang Lua Chon",695000,625000,5,1,10
0,0,AO THUN NAM NGAN TAY CO TIM MAU MOI NHIEU MAU,117000,117000,5,3,7
0,0,Quan lot nam - Sip nam cao cap - Sip nam tam giac Malefix Bikini Ryan 06016,149000,149000,5,1,6
0,0,Ao So Mi Form Rong Unisex Nam Nu Tay Dai Han Quoc Kieu Co Vest Co Ve Ao Khoac Ngoai Vai Lua Mem Min - SMV01,129000,129000,5,5,6
74500,50,Quan short dui vai thoi trang nam TUTO5 tron basic chat ni xin thun dang the thao cao cap QDS1000,149000,74500,5,1,7
0,0,Ao thun nam co co ca sau vai loai 1 nhap tu thai lan loai ao thun tay lo size 55kg den 85kg,79000,79000,4.5,11,30
0,0,Quan au nam trung nien ong suong vai cotton 2 da day mat loai quan tay nam form rong QTTN220,89000,89000,5,2,9
0,0,Ao so mi nam dai tay tron mau khong tui Biluxury 5SMDB002DEN,535000,535000,5,1,3
0,0,Ao So Mi Tho Coc Tay Nam Tui Nguc T3321C1729 - GENVIET,418000,418000,5,1,1
0,0,Ao so mi trang nam dai tay vai lua thai co dan min mat loai ao so mi body han quoc ASLD10,79000,79000,5,1,6
0,0,ao sat nach nam the thao van dap vai thun lanh mem min mac cuc thich loai ao thun the thao tap gym ATSN02,49000,49000,5,1,8
0,0,"Quan Short Nam ROUGH Dang Coc, Chat Nhung Tam Tre Trung, Ca Tinh",130000,130000,4.5,2,3
0,0,ComBo 4 Quan Sip Nam    Quan Lot Nam Munafile 899,69000,69000,2,1,1
0,0,Ao so mi dui co tru nam tay ngan trung nien SIEU MAT loai ao so mi nam trung nien form rong co lanh tu ASMDOG65,99000,99000,4.5,4,21
0,0,Ao co tau trung trung nien vai dui tron SIEU MAT form rong rai thoai mai loai ao so mi nam co lanh tu form rong ASMDOG65,99000,99000,3.7,3,9
0,0,Ao Lot Nam Co Tay Cotton 100% Hang Cao Cap,29000,29000,4.2,13,90
46000,20,"Set 3 Quan Sip Nam Quan Lot Nam Soi Cotton Cap Nho Mem Min Thoang Mat, Co Gian 4 Chieu Thuong Hieu MRM FASHION - MM",225000,179000,5,9,21
0,0,Bo 3 Quan Boxer Duc Nam Nhat Ban (Nhieu mau) - 5Star,99000,99000,1,1,
0,0,Ao thun nam polo coton cao cap vai min mem sieu mat size 50-80kg soc co soc tay,89000,89000,5,2,12
0,0,"Do bo Pijama-Do ngu nam cao cap phong cach Han Quoc, chat COTTON 100 day dan & thoang khi (711)",450000,450000,3.4,5,16
179000,60,Quan Short Nam The Thao Mua He Thoi Trang Cao cap ZERO,298000,119000,4.2,6,15
0,0,Ao Thun Nam Co Tim Blentino TS06 Co Gian Da Chieu,185000,185000,5,1,2
105000,28,"Combo 2 Ao Thun Nam Body Co Tron Tre Trung, Nang Dong, Soi Cotton Cao Cap Mem Min Sieu Thoang Mat, Co Gian 4 Chieu MRM FASHION ( cung mau )",370000,265000,4.5,8,19
0,0,ao so mi nam tay ngan tay CAO CAP form regular loai so mi cong so vai cotton dep ASHN10,99000,99000,5,1,
0,0,Set Do Bo Mac Nha Nam Clothing MeoHOT RE DEPDo The Thao Da Bong Ao thun Unisex Rong Phoi Quan Short Dui In Chu -Suit - HIEN LINH SHOP SET DO BO NAM,83000,83000,0,0,1
0,0,Ao khoac bomber du FOREST logo theu sac net - form rong unisex cap doi nam nu Couple deu mac duoc,95000,95000,0,0,
0,0,Ao so mi nam dai tay tron mau khong tui 5SMDB002TRK,535000,535000,5,1,1
0,0,"Ao khoac du nam , ao khoac du nu ,Ao khoac gio nam nu mac , ao khoac cap vai du 2 lop siz eL va XL ( HINH THAT )",95000,95000,4.5,2,2
0,0,Ao Khoac Hoodie Heavy Mau Vang [ TANG 1 NON HEAVY ] Chat Ni Mem Min Kieu Dang Tre Trung Danh Cho Ca Nam Va Nu Du Size Team Heavy,159000,159000,4.5,20,44
0,0,"Ao hoodie nam chu X , ao hoodie , ao khoac nam , ao hoodie form rong , ao hoodie co non , ao khoac hoodie chong nang chong lanh vai thun ni",89000,89000,5,4,20
111200,44,"Quan short jeans nam , quan sort nam eo co dan tron lich lam mau J67 san lai thiet ke phong cach thoi thuong loi cuon dao pho Julido thoi trang han quoc trung nien",250200,139000,4.5,9,32
173000,51,Bo Mac Nha The  Thao Nam Mua He Thun Mong Cao Cap ZERO - BTT17 DEN - M,338000,165000,5,3,7
173000,51,Bo Mac Nha The  Thao Nam Mua He Thun Mong Cao Cap ZERO - BTT17 DEN - XL,338000,165000,4.7,3,9
150000,50,Ao Ni Nam Chat Lieu Cao Cap 8 Mau VICERO,300000,150000,5,9,27
51000,21,"Combo 3 quan sip nam quan lot nam Tam Giac Cao Cap MRM FASHION ( Den,Ghi)",240000,189000,4.8,8,21
129000,50,Quan Short Nam The Thao Co Gian Cao Cap VICERO 5 Mau,258000,129000,4.1,9,34
0,0,Quan tay nam big size loai quan vai cotton dep loai quan tay ong rong,99000,99000,4.5,10,26
36000,15,Ao Khoac Big Size Nam Nu Ao Khoac Kaki Bomber Nam Nu Chong Nang Chong Lanh Chong Gio Chong Nong Hai lop Thoi Trang FS Han Quoc Nam Tinh Gia Re Cao Cap WK46 - ShopN6,235000,199000,4.5,2,4
0,0,"Ao so mi nam dai tay cong so caro TUTO5 thoi trang cao cap chat dep Extraslimfit Shirt khang khuan khu mui tot, it nhan",199000,199000,5,3,5
0,0,Ao Thun Unisex Nam Nu Form Rong SDVN Lucid Dream,150000,150000,5,1,1
0,0,Ao so mi nam tay ngan co tru,142800,142800,0,0,
11000,10,Combo 5 bo quan lot nam lung thun co gian 4 chieu cao cap ShopN6 - QLT5 (mau toi + chu ngau nhien),110000,99000,5,1,14
0,0,"Ao Thun Nam Phan Quang In hinh PIKACHU , ao chat, di dem, di phuot bao ngau, nhin da mat",60000,60000,4.8,6,20
0,0,Ao thun co lo nam TN13,55000,55000,4,1,7
0,0,"Ao Thun Nam_ Nu  Phan Quang In hinh KIEM KHACH , ao chat, di dem, di phuot bao ngau, nhin da mat",60000,60000,4.5,17,38
0,0,"Quan jogger kaki tui hop G-ALPHA Phan Quang Tui, quan jogger kaki ulzzang G-ALPHA - F023",95000,95000,0,0,2
0,0,Quan kaki tui hop nam chat kaki tot size M L XL,95000,95000,4.7,3,7
0,0,Ao So mi Nam Hoa Tiet Tay Ngan AKUBA | 01AB2101,549000,549000,5,1,4
0,0,Bo 5 Quan Lot Nam Nhat Cao Cap (Giao Mau Ngau Nhien),140000,140000,5,2,25
0,0,Ao so nam viet tien dai tay,350000,350000,4.7,25,94
0,0,"Ao khoac jean nam King168 , ao khoac bo cao cap AK10",184000,184000,4.5,2,4
39000,50,Ao Thun Nam Tay Dai Co Tron,78000,39000,0,0,
0,0,"QUAN KAKI TUI HOP NAM NU MAC SIZE M , L VA XL",97000,97000,5,1,2
0,0,"Ao thun nam co be ngan tay cao cap phong cach han quoc, ao thun polo nam MURADFASHION AT033",99000,99000,3.7,3,4
144000,44,"Quan Sot Jean nam co dan 4 chieu Thuong Hieu Chandi, phong cach han quoc mau moi nhat 2021 MSM2",324000,180000,5,9,31
0,0,Ao Polo Nam Mau Tron The Basic Vai Ca Sau Co Gian 4 Chieu,109000,109000,4.7,47,122
0,0,Ao polo nam trung nien soc ngang vai thun mat loai ao thun nam ngan tay co co fom rong rai ATSG60,99000,99000,3,2,13
0,0,Ao so mi nam viet tien ngan tay mau xanh den,300000,300000,3.7,3,7
0,0,HOT ao Naruto in hinh dep Ao phong Itachi Sasuke dep gia re thoi trang nam,99000,99000,4.2,5,8
0,0,"Ao ni Hoodie Drew house mat cuoi , ao ni bong hoodie unisex nam nu",179000,179000,1,1,5
0,0,Quan kaki nam TRUNG NIEN Santino chat lieu cotton cao cap dang xuong thoai mai sang trong KKG595K611,535500,535500,3.7,3,17
0,0,AO KHOAC DU NAM NU AO KHOAC CAP CAO CAP ,250000,250000,4.7,3,4
0,0,Ao len nam han quoc lot long LNA05,520000,520000,5,1,4
168000,60,"Ao polo nam phoi co GUMAC du mau, phong cach thanh lich ATNB465",280000,112000,4.5,2,13
0,0,Ao khoac phao nam co non logo theu cuc dep thoi trang nam am ap ,155000,155000,4,1,2
0,0,Ao thun tay dai nam form rong unisex nam nu vai thun day dan ,80000,80000,5,2,3
0,0,Bo 3 Quan Boxer Duc Cao Cap Nhat Ban Cho Nam,180000,180000,5,1,1
0,0,Quan Lot Nam Combo 5 quan sip xuat Nhat loai 1 (cheo - dui) giao mau ngau nhien,107000,107000,0,0,
51000,13,Combo 5 quan lot tam giac nam du mau thuong hieu Coolmate (3 mau),400000,349000,5,1,18
0,0,Ao Len Nam nhieu  Mau co ba phan Tron Phong Cach Tre Trung Lich Lam duoc nhap khau boi cong ty XUAN ANH,170000,170000,2.5,2,3
0,0,Ao So Mi Nam Tay Ngan Hoa Tiet The Shirts Studio Han Quoc TD09S2769WH,79000,79000,2.8,6,17
89000,56,Ao So Mi Ngan Tay Nam Phong Cach Cong So Thoi Trang Cao Cap VICERO,158000,69000,4.2,11,36
165000,50,Ao thun nam in LOS ANGELES GUMAC ATNB6104,330000,165000,5,3,3
133000,31,Quan Short Jean Nam Thoi Trang AKUBA Form Skinny | 01D19104,429000,296000,5,1,6
124000,33,Ao thun nam hoa tiet tay ngan Oversize AKUBA | 01JW179,379000,255000,5,1,4
43000,10,"Ao so mi nam den tron AKUBA form regular, chat lieu cotton, vai it nhan, tham hut mo hoi tot, da xu ly co rut 01M0058",439000,396000,4,2,
0,0,"Combo 3 quan sip tam giac, Set 3 quan lot nam dang Brief ARISTINO chat lieu Bamboo thoang mat, khang khuan khu mui cuc tot AC-06",240000,240000,5,6,20
131000,44,Ao khoac kaki nam Hahaman thoi trang cao cap nhieu mau KK20,300000,169000,4.2,19,45
0,0,"Ao khoac jean 2 day keo ca tinh may mac life, ao bo nam phong cach ca tinh",399000,399000,4.3,3,6
0,0,Sip Dui- Quan Lot Nam Boxer Soc Ngang Cotton Sieu Mem Form To Thoang Khi K458,48000,48000,4.5,4,12
0,0,Quan Jean Nam Cao Cap Co Gian Manh BH 50,159000,159000,0,0,
0,0,Quan short kaki nam - Xam - 28,75000,75000,0,0,30
0,0,Quan Thun Nam Dai Vai Thun Ni,85000,85000,2.7,6,13
0,0,Quan the thao nam thun the duc ma TT27 kieu jogger bo ong Han Quoc dep ong dai,39000,39000,1,3,8
0,0,"Quan 1 soc suon unisex , Quan ong suon 1 soc , quan 1 line , quan soc nam nu ni cotton",60000,60000,4.3,10,26
0,0,"Quan the thao ong rong,Quan Jogger,quan the thao nam ong rong,quan the thao nu rong Unisex QT1",0,329000,4.5,34,
0,0,quan 3 soc suon unisex nam nu vai ni cotton cao cap form dep - 3 line striped pants,55000,55000,4,1,6
0,0,Quan nam Quan dui dai nam ong suong Form Slimfit dang au,79000,79000,5,1,4
0,0,COMBO 3 AO LOT NAM BA LO CAO CAP TL010110,110000,110000,4.2,5,16
78000,16,Combo 3 quan lot nam khong duong may Trunk Seamless iBasic PANM095,477000,399000,5,1,2
0,0,Ao Da Nam Ao Mang To Nam Dang Dai San Hang Chat Dep Sans Shop Sans02,0,629000,3.3,3,
0,0,Quan Jean Nam Xanh Dam Han Quoc XANHDAM52 - Xanh Dam,134000,134000,3.3,3,4
0,0,Quan Sot Jean Nam M1,89000,89000,4.2,10,27
0,0,Quan Jean Dai Nam,225000,225000,4,1,1
0,0,Quan Jean Nam Trung Nien Ong Suong H234,150000,150000,3.3,8,25
0,0,Quan lung nam Quan dui the thao nam he cao cap dep nhat,110000,110000,2.6,9,37
0,0,"Ao khoac jean thoi trang cao cap nam King168 , ao khoac chat jean cao cap nam M50",0,250000,5,2,
0,0,Ao thun nam ngan tay loang mau NOVELTY 210142,195000,195000,4.7,3,6
31350,11,COMBO 3 QUAN LOT NAM BRIEF  - RLTK013,285000,253650,1,2,3
50000,50,Ao Sweater Ni Chui Tron Nam Nu Deu Mac Duoc De Dang Phoi Do,100000,50000,3.7,3,7
50000,50,"Ao lot nam cao cap Narsis NMS1277 mau den xuoc  tre trung nang dong, chat lieu  cao cap cuc mem mai thong thoang",100000,50000,4,1,1
65000,20,"Quan jogger nam thu dong Narsis G8030B mau sac tre trung nang dong, chat lieu Ni len cao cap cuc mem mai am ap, san pham duoc san xuat tai Viet Nam boi thuong hieu thoi trang noi tieng NARSIS",325000,260000,5,2,7
59000,20,Ao Nam Thu Dong NARSIS D7086,295000,236000,4.3,3,18
59000,20,Ao Nam Thu Dong NARSIS D7060,295000,236000,5,1,2
79000,20,Quan Jogger Nam Narsis G8006 ni xanh ke den,395000,316000,1,2,2
0,0,"Bo quan ao the thao nam, bo quan ao nam chu US , bo ao va quan nam ,  bo do 3 lo",65000,65000,4.6,5,11
116550,45,Ao Thun Nam Tay Lo Unisex co Tron chat lieu vai cotton mau den form rong n Phan Quang 7 mau Ngua 1 sung Unicon phong cach doc chat NS063,259000,142450,4.7,23,66
195000,39,Ao thun nam nu unisex Stee Watch WORSE mau trang 100% cotton 4 chieu Trum Unisex aothununisex,500000,305000,5,1,2
25920,45,Ao thun unisex form rong tay lung nam nu han quoc in Phan Quang Eagle PhillipStore,57600,31680,1,2,3
0,0,Ao so mi nam tay dai hoa tiet Santino chat lieu soi tre chong tia UV dang lim sang trong ASD525S592,472500,472500,4,1,2
0,0,"QUAN JEANS JOGGER NAM, QUAN BO NAM TRE TRUNG, SANH DIEU",269000,269000,5,11,23
244000,41,Ao Sweater Unisex BOO Ni Khong Mu Dang Oversize Vai Loang Mau Tie Dye In Graphic Yoda StarWars,599000,355000,5,1,2
0,0,"AO PHONG NAM DAI TAY COTTON DAY MIN,Ao phong nam, Ao thun nam tay dai. Ao phong nam tay , ao thun",149000,149000,3.3,3,7
93132,39,Quan Jean nam Den Rach Goi Zipper - GIa Si Phillipstore,238800,145668,4,1,
0,0,Ao Suoi Dien Ghi le Nam Nu su dung pin sac du phong,750000,750000,4.7,3,7
0,0,Ao Thun thoi trang phong cach Han Quoc 206354,67470,67470,5,1,1
102090,41,Ao Thun Nam Tay Lo Unisex co Tron chat lieu vai cotton mau vang form rong in chu LIMIT EDITION phong cach doc chat TheNgaustyle,249000,146910,5,4,4
59040,41, Ao thun nam tay lo form rong GRAVITY han quoc vai cotton trumunisex,144000,84960,4,2,3
141000,49,Quan Baggy Kaki unisex N7 Basic nam nu cap chun ong rong phong cach Han Quoc ,290000,149000,4,2,16
0,0,"Ao khoac so mi nam caro , ao hoac so mi nu caro , ao caro nam , ao caro nu , ao khoac UNISEX kieu dang so mi soc caro nhuyen mau xanh , ao so mi caro co non",97000,97000,0,0,1
97110,39,Ao thun Tay lo Nam Nu Form Rong In decal M.U.S.T mau trang Trum Unisex vai cotton thich hop di choi,249000,151890,4.3,3,3
253500,15,Ao gio the thao nam AJDQ463-2 Li-Ning,1690000,1436500,5,1,1
0,0,"Quan lót nam kiẻu sip tam giac Voga Hang Ngay vai cotton thoang mat, hut am, khu mui",79000,79000,4.7,22,123
62000,33,Quan Lot Nam Jockey Tam Giac Ban To Thun Cotton Compact Mau Trang Tham Hut Mo Hoi Thoang Mat - JMMB7336,190000,128000,5,1,11
159000,53,Quan Dui Nam Vai Kaki Cao Cap Thoi Trang Vicero,298000,139000,5,3,11
0,0,"Ao khoac phao nam co non , form rong lot bong cuc am ap",155000,155000,1,1,6
0,0,Ao so mi nam denim tay dai Nexx & Dee hai tui cong so trang vai jean cao cap tre trung nien ND02,239000,239000,3.3,4,8
0,0,"Ao khoac nam nu chat lieu gio cao cap 2 lop day dan, ben trong lot luoi, ao khoac du chong nuoc",145000,145000,0,0,
133000,50,Ao thun nam GUMAC ATNB798 in chu Cool,265000,132000,4.7,3,14
0,0,Quan short kaki lung thun,49000,49000,4,4,10
0,0,"AO THUN CO BE NAM, AO POLO THOI TRANG NGAN TAY, CHAT THUN CA SAU DE PHOI DO  - LZPS114",124000,124000,4,1,2
0,0, Quan Tay Dui Dai Nam Dang Suong Co Gian Thoang Mat Cap - Khuy - Lung Thun- Hot He 2020 ,114000,114000,4.1,10,42
0,0,Quan ngu nam kiem quan lot luoi the thao,98900,98900,5,9,32
0,0,Bo Quan Ao Nam Thu Dong - E5017,895000,895000,4.1,7,16
111000,44,Quan Short Nam Kaki Mem Min VICERO 5 Mau Tre Trung Phong Cach Han Quoc,250000,139000,4.2,20,89
72000,34,Quan Lot Nam Jockey Trunk Boxer Ban To Thun Cotton Compact Mau Trang Thoang Khi Cao Cap - JMMB7337,210000,138000,5,1,2
159000,53,Quan Dui Nam Kaki VICERO 6 Mau Tre Trung Phong Cach Han Quoc,298000,139000,4.7,12,26
0,0,"Áo polo nam cỏ bẻ, áo thun nam COOLMAX POLO thoang khi, sieu co gian tu TORANO TP302",330000,330000,5,5,7
87000,47,Quan Lot Nam Jockey Trunk Ban To Thun Cotton In Soc - JUMB0309,185000,98000,3.8,4,21
0,0,AO K&K CA MUC HAM MAT - KEM ANH THAT- LY HIEN - DUONG TU - HO NHAT THIEN - GUN THAN,143000,143000,5,3,3
0,0,Ao Khoac Bomber Teelab BlackJack AK020,300000,300000,3,2,8
0,0,"Quan Thun jogger ong rong vai ni ep khong xu 2 mau Den Xam,form Unisex Nam Nu",49000,49000,1,2,
20000,16,Quan lot nam thun cotton Brief iBasic PANM081,129000,109000,4,1,12
0,0," Quan Jogger ni nam manh me, chat Men",52000,52000,4,3,4
0,0,Hop 4 Quan Lot Nam Dui Xuat Nhat Loai khong lo Sunzin4MJ - Mau Ngau Nhien,87350,87350,1.3,3,43
0,0,Ao giu nhiet Nam co ba phan sieu am,39000,39000,1,1,2
237000,60,Ao thun polo nam phoi bo co GUMAC ATNB396,396000,159000,4.7,15,39
0,0,Quan Jeans Baggy Dang Rach Goi 2020,0,190950,5,1,
0,0, ao phong nam danh cho nguoi beo,75000,75000,5,1,2
0,0,Ao thun nam ngoai co,68000,68000,5,1,1
0,0,Ao phong cho nam va nu - Ao thun nam big size - Ao thun nam danh cho nguoi beo,68000,68000,3.7,3,6
0,0,"Ao so mi dui nam ngan tay co be, thiet ke lich su tre trung (SMD119)",99000,99000,5,3,4
0,0,AO THUN NAM MAU DEN VAI COTTON AO THUN TSHIRT UNISEX NAM NU THO INSANE,50000,50000,1,1,5
0,0,AO HOODIE NON NAM MAU DEN CHAT VAI NI HANG FREESIZE 1 CO FORM DANG RONG DUOI 65KG,68000,68000,5,1,7
0,0,Quan Jean baggy nam rach goi+ canh ma RGC- 01 hot 2021,0,179550,4,1,
0,0, Ao Thun Trang Nam,68000,68000,5,1,1
0,0,ÁO KHOÁC DA NAM LÓT LONG CAO CÁP,296000,296000,0,0,
0,0,"Ao thun Nam Nu Vonesa, ao phong Unisex Nam Nu co Size tu 25-84kg B8",45000,45000,5,1,1
0,0,Quan Jean Nam Ong Suong,105000,105000,2.9,16,87
68000,35,Ao thun nam GUMAC ATNB824 in hoa tiet mau moi,195000,127000,4.8,4,25
188000,25,Ao Hoodie Ni Co Mu Unisex BOO Dang Ovesized Loang Mau Tie Dye Doc Dao Graphic Mandalorian,749000,561000,5,1,1
0,0,"Ao So Mi Nam Tay Dai Chat Lieu Kate Lua Chong Nhan Nhieu Mau, Nhieu Size",79000,79000,4.5,207,713
0,0,Ao Tho Tron Vat Bau Chat Lieu Tho Dui Thoang Mat,189150,189150,5,1,5
0,0,"Hop 4 quan sip dui Men thong hoi, thoang khi kem hop",84460,84460,0,0,3
192000,36,Ao So Mi Nam Tay Ngan Hoa Tiet Caro AKUBA | 02B454,529000,337000,4.5,2,6
0,0,AO KHOAC PHAO NAM THOI TRANG AM AP MUA DONG KN 09,150000,150000,2,1,8
0,0,AO SO MI CAP DOI NAM NU  I LOVE YOU HOT TREND XU HUONG TINH YEU HAN QUOC,89000,89000,5,5,5
0,0,Ao khoac jean nam thoi trang han quoc sieu chat cao cap - Hot New 2021,139200,139200,4.5,2,2
49000,21,Ao so mi kaki nam dai tay THE 1992 Form Regular Fit,238000,189000,4.8,4,9
51000,20,"Combo 2 ao ba lo nam/ao 3 lo nam, soi cotton mem min sieu thoang mat, tham hut mo hoi cuc tot, co gian 4 chieu MRM FASHION -CM",250000,199000,4.5,34,138
59000,10,Ao Thun Nam Co Co Giordano Classic Polo 01019260,590000,531000,5,2,9
126000,45,"Ao thun nam tay ngan tron AKUBA form slimfit vai min, co gian 4 chieu thoai mai van dong 01J655",279000,153000,4.8,4,41
150000,38,Ao khoac du 2 mat 2 lop chong truot nuoc Lados - 2015 form unisex tre trung don de phoi,399000,249000,5,1,
41000,19,[ Co anh that ] Ao so mi unisex form rong - somi nam nu soc so 20,220000,179000,5,2,4
119000,50,Ao sweater unisex nam nu cap doi hoodie local brand han quoc cute khoac zip choang cardigan chong nang GAU TRUC,238000,119000,3,1,1
59000,50,Ao thun nam tay ngan co tron body streetwear phong unisex basic tee cotton teen oversize den trang gia re SMIPLEST,118000,59000,3.7,3,12
59000,50,Ao phong nu nam unisex tay lo thun form rong teen co tron oversize cotton gia re basic den trang tee pull freesize  TUOKEORIGIN,118000,59000,3,1,
59000,50,Ao cotton nam nu unisex thun tay lo ulzzang phong den cotton oversize form rong in hinh cool ngau EVERYSTREETIME ,118000,59000,5,1,2
59000,50,Ao phong nam nu unisex form rong tay lo thun MARSHMELLO teen co tron oversize cotton gia re mau den trang tee pull,118000,59000,5,1,1
59000,50,Ao thun unisex form rong nu nam phong unisex co tron cotton oversize gia re in hinh MONEY ,118000,59000,1,1,8
59000,50,Ao thun nu nam form rong giau quan unisex phong basic teen co tron cotton oversize gia re in style ulzzang KHUNG LONG CUTE,118000,59000,5,1,2
0,0,Quan Jeans thung tui cheo nam trung nien chat co gian,0,395000,3.6,11,
281000,48,Quan Jean Nam Form Slimfit AKUBA | 01AB2082,580000,299000,4.5,7,11
0,0,Quan lung jean thun nam co gian hang dep,67000,67000,1,1,3
0,0,Quan Tay Nam Vai Tuyet Mua DEN98 (Den) - 31,85000,85000,1,1,32
0,0,Quan Vai Nam Dang Cong So DEN97 (Den),125000,125000,3.8,12,40
0,0,"Ao so mi nam tron, tay dai - Trang - XL",63000,63000,0,0,31
181000,50,Ao Khoac Hoodie Ni Bong BAN CO mau TRANG/DEN Nam nu unisex/Ao hoodie co mu form rong Jaystoree ,360000,179000,5,2,2
55000,12,Ao Khoac nam lot long day dan sieu am - H22,450000,395000,5,1,21
0,0,Ao so mi nam dai tay ke hai soc,95000,95000,5,1,1
0,0,Quan ngu nam thun lanh thoang mat mua he Qshop QC125-QC126-QC127-QC128,100000,100000,4.6,5,19
55000,50,"Quan Lot Nam Boxer 5S (4 mau) Cap Det Khong Duong May, Vai Mem Mat, Co Gian, Khang Khuan Tot (SIP21011BOX)",110000,55000,3.5,2,13
0,0,Ao khoac da nam dang vest tre trung NAD43,2250000,2250000,5,1,1
173000,51,Bo Mac Nha The  Thao Nam Mua He Thun Mong Cao Cap ZERO - BTT19 XAM - M,338000,165000,3.9,9,13
0,0,Ao Hoodie Drew house mat cuoi Kunshop ao ni bong hoodie unisex nam nu,120000,120000,4.7,3,10
0,0,QUAN JOGGER NI NAM PHOI VIEN JAIFNEE,75000,75000,5,3,13
0,0,Quan Boi Nam Den - Giao vien mau ngau nhien,70000,70000,5,3,14
0,0,"Quan dui the thao nam, Combo 5 Quan Short Nam Caro Chat Cotton Dep - Hang xuat khau",107000,107000,0,0,
0,0,Ao so mi nam tay dai han quoc phoi soc,199000,199000,4,6,17
123000,41,Quan Jogger The Thao Nam Chat Ny Thoi Trang Cao Cap ZERO,298000,175000,4.5,117,235
0,0,Ao So mi Nam Nu Unisex vai Nhung Gan ao khoac so mi form rong anh that,165000,165000,0,0,
0,0,Blentino quan au(quan tay) nam SQD01(2),595000,595000,4.3,6,19
73710,30,Quan jogger kaki nam,245700,171990,5,1,2
0,0,Quan jogger nam nu vai kaki co gian ong bo khoa zip ca tinh (k1),75000,75000,4,1,8
0,0,Ao so mi nam tay dai phoi hoa tiet theu chu cao cap,148000,148000,4,8,20
0,0,"Quan Jean Nam chat Bo cao cap ️️ Jean Nam Den tron dep nhu hinh, chat lieu co gian mau moi To To Shop - QJNM60",159000,159000,5,1,
0,0, Ao khoac One Piece RAU TRANG DOC dep re chat luong,167400,167400,5,1,
0,0,Do bo nam thoi trang hotfrend phong cach Han Quoc 2 mau den xam chat vai thun cootn mem min co dan 4 chieu,120150,120150,5,1,1
0,0,Ao Ba Lo Nam,24900,24900,4,1,
0,0,Quan jean nam rach goi vai bo co gian ms 2034,112000,112000,5,1,
75000,50,"Quan jogger  the thao 3 soc BO ONG nang dong ca tinh, chat vai quan ni co gian 4 chieu",150000,75000,5,2,4
0,0,"Ao thun Nam Nu Khong co HANH DONG CIMT-0004 mau moi cuc dep, co size be cho tre em / ao thun Anime Manga Unisex Nam Nu, ao phong thiet ke co tron basic coc tay thoang mat",39999,39999,5,1,1
0,0,"Ao thun tay lo form rong STREETWEAR phong unisex nam nu, ao thun cotton100% phong cach streetstyle HINH IN KO TROC",189000,189000,5,1,1
0,0,"[COMBO 3] Ao sat nach the thao nam, tank top ba lo tron nhieu mau phong cach han quoc mac tap gym, bong ro",125000,125000,5,2,4
0,0,quan ngo tho kaki nam trung nien ngon bo re dang thung tui cheo,149000,149000,5,1,
0,0,( Xa kho) SCT Bo dui nam phong cach Han quoc!,189000,189000,4.5,5,14
0,0,AO KHOAC DU NAM CAO CAP,199000,199000,4.5,2,3
0,0,"Bo nam coc tay quan dai chat cotton mat min, lich su nam tinh phu hop mac trong nha, di dao",380000,380000,4.5,2,5
0,0,AO KHOAC NI NAM NU FORM RONG CO TUI CUC HOT,170000,170000,1,1,
50000,21,"Ao Len Nam Co Tron Hoa Tiet Xuong Ca, hang nhap Quang Chau",238800,188800,4,1,
0,0,"COMBO 4 quan lot nam chat cotton thoang mat, quan sip nam Boxer tre trung, hien dai AVI - 388",109000,109000,4,1,5
0,0,"Bo do mac nha cho ong, cho bo ( co tau ngan tay2 )",287500,287500,4,1,2
0,0,Ao So Mi Nam Dai Tay :: Ao So Mi Nam Dep Chat Dui Co Be,139000,139000,5,1,1
0,0,Ao Hoodie Mau Cam Form Unisex In Hinh Ca Tinh - LZGV041,159000,159000,5,1,
0,0,SET BO THUN THAI NAM THICH HOP DI DAO,69000,69000,1,1,2
0,0,Ao Thun Nam Co Polo Soc Nau Trang GV02 Thoi Trang Han Quoc Cao Cap Chat Vai Khong Xu Khong Phai Mau,125000,125000,3,1,2
0,0,"Quan boxer nam cotton min mong thoang khi co gian tot cao cap, quan lot nam, sip cotton tre trung K117",57000,57000,4.5,2,11
0,0,AO THUN TRON CO CO,75000,75000,5,5,8
0,0,"{ DUI DEP 4 MUA } B45 Bo dui dai trung nien, Chat lieu dui tu nhien 100%",229000,229000,4.7,14,49
0,0, Ao Den 3D Free Fire Rank Dai Kien Tuong,100980,100980,5,1,2
0,0,AO THUN NAM TU 50-90kg Link dat tren live,85000,85000,5,1,2
0,0,AO KHOAC NI HOODIES NAM NU FORM RONG,79000,79000,5,1,1
0,0,"Quan Jean Nam Ong Rong ,Quan Jean Nam Hot Trend 2021,Quan Jean Nam Baggy",200000,200000,5,1,5
0,0,HOT Mau ao thun team game SKT T1 2020 cuc ngau mau moi cuc chat,128700,128700,4,3,3
0,0,Quan Tay Nam Titishop AVN193 Do Do,370000,370000,5,1,2
151000,50,Ao Thun Nam Polo in Hoa Tiet HAHAMAN thoi trang cao cap ATPL01009,300000,149000,5,2,2
0,0,Quan lot nam det kim,36000,36000,4,1,
0,0,Ao len nam co tim hang Quang Chau,200000,200000,1,1,1
0,0,AO KHOAC DU 2 LOP NHIEU MAU SAC SINH DONG,99000,99000,1,1,1
0,0,"Ao Polo nam phoi co be co tui vai ca sau Cotton xuat xin,chuan form tre trung, thanh lich",157000,157000,5,1,6
0,0,COMBO 2 QUAN LOT NAM COTON CAO CAP SIEU MEM MAI DL077,99000,99000,3,2,2
0,0,Ao khoac Luffy - ao One Piece gia sieu re,238000,238000,5,1,2
0,0,AO THUN NAM DAI TAY PHOI CAO CAP,149000,149000,3,2,3
0,0,Quan jean nam rach 3 duong mau den,290000,290000,5,1,1
0,0,Áo Hoodie Undertale/Sans chát choi.,179000,179000,5,1,2
0,0,Ao khoac jean nam gabofashion thoi trang tre AKJN001,299000,299000,5,1,
0,0,"Quan boxer nam Quan Lot Nam XGHU sieu mem min, thoang mat, chat thun co gian 4 chieu",90000,90000,1,1,2
0,0,AO DAI TAY NAM COTTON,149000,149000,4,2,2
0,0,Quan jean nam dai 2021,240000,240000,5,1,1
0,0,"Ao Thun Nam Phan Quang EVIL MONSTER Ao Uninsex Size Rong,  Size Lon, Size Nho, Tay Ngan, Co Tron, Ao Nam Size Lon, Co Ao Thun Size 2XL, 3XL, 4XL, XXL, XXXL, XXXXL",59000,59000,4.5,4,11
0,0,Ao Thun Nam Motorcycle - Biker T-Shirt Den in HARLEY DAVIDSON DAI BANG LON - MOTOR T-SHIRT,416000,416000,5,1,2
0,0,Quan Short Kaki Tui Hop Nam Nu Unisex,165000,165000,5,1,1
82000,32,COMBO 2 QUAN SHORT NAM KATE 100%  COTTON  FEZZIO CHINH HANG FZ05-NEO ,258000,176000,2,1,2
0,0,Ao polo ngan tay nam Owen Bodyfit mau xam - APV21863,450000,450000,5,1,2
0,0,Ao Thun Nam Phan Quang 7 Mau Optimus Prime,60000,60000,5,1,5
0,0,Quan lot nam sip dui thun lanh sieu mat TL01A,48000,48000,4,1,6
0,0,HOT Mau ao thun One Piece unisex - ao Zoro dep gia sieu re,94800,94800,3,1,
0,0,quan short thun co gian day keo mau kem,89000,89000,2,1,1
0,0,Ao khoac Alan Walker tre em dep nhat  re chat luong,167300,167300,3,2,2
71000,28,"Ao so mi dui nam co tru tay lo tre trung ArcticHunter, thoi trang phong cach Han",250000,179000,5,2,1
0,0,Bo quan ao dai gia co tau chat mem mat cho cac ong bo,269000,269000,1,1,2
0,0, Ao thun Anime in hinh Team Naruto Sasuke mau moi gia re,90360,90360,5,1,3
0,0,Quan jean nam co gian rach ong con JN5511,250000,250000,5,1,2
0,0,"Ao Polo Nam Co Co Cao Cap Co Gian Nhieu Mau Sac,Trung Nien , Tre Trung, Lich Lam Ben Re AL37",79000,79000,5,1,4
0,0,"Quan Jean Nam chat Bo cao cap ️️ Jean Nam Den tron dep nhu hinh, chat lieu co gian mau moi To To Shop - QJNM59",159000,159000,1,1,1
0,0,Ao Rock: ao Dai tay My Chemical Romance TDM 0765,295000,295000,5,1,1
0,0,quan jean rach bui nam ca tinh ( ma 115),262000,262000,5,1,1
0,0,Quan short thun nam 3 soc chat vai mac mat tu 40-75kg mac vua (1 quan ),45000,45000,4,1,4
0,0,AO THUN NAM CO BE,90000,90000,2,1,3
0,0,Ao Thun Nam The Thao Co Tron Phoi Vai Chat Cotton Ca Sau 5 Mau Phoi Vai Tre Trung,129000,129000,1,1,
0,0,Ao Tay Lo Unisex Phan Quang Dragon Ball Rong Vai Min Du size_dau Sogoku,51000,51000,5,1,3
0,0,"Ao Phong Polo Nam Nu Co Co Chat Lieu Cao Cap, Phoi Vien Sang Trong, Vai Mem, Co Gian, Chong Nhan Cuc Tot",119000,119000,4.5,8,30
0,0,Ao so mi nam caro HAHAMAN dang body cao cap ngan tay SMSILK259,149000,149000,4,1,1
0,0,Ao khoac da lon co bomber Amintino bomber da lon thiet ke tre trung,250000,250000,5,1,1
0,0,"Ao gio nam trung nien ZENTOMAN cao cap chong nuoc, 2 lop giu nhiet, gio li khong nhan sieu nhe AG220",920000,920000,1,1,1
18000,26,Quan dui nam gabofashion tui khoa the thao cao cap qdtt103,69000,51000,5,1,4
0,0,Quan the thao ni bong sieu am,39000,39000,0,0,
0,0,Ao thun nam trung nien co tui cao cap-Chat lieu cotton ca sau cao cap - Form suong thoai mai size 52 toi 85kg.,159000,159000,5,1,
0,0,BO THE THAO NAM DA CA CHEO LINING,106000,106000,4,1,
0,0,Ao Phao Nam 3 Lop Dang Bomber Thoi Trang Cao Cap BBY,159000,159000,4,1,6
0,0,"Quan jogger nam thun POLY xin so co khoa tui, phong cach the thao voi hoa tiet tron co big size den hon 80kg",79000,79000,5,2,4
0,0,"Ao Phong Nam W&W Dang Regular Fit- Co Tron Ngan Tay Mau Tron Chat Lieu Thoang Mat, Tham Hut Tot WTS47R",255000,255000,5,1,
0,0,AO KHOAC NI NAM 01,200000,200000,3.2,5,15
0,0,Combo 6 quan dui mac nha nam cao cap kate 100% cotton,414000,414000,5,1,2
0,0,Ao thun nam bigsize,120000,120000,4,1,1
0,0,AO KHOAC KAKI PHONG CACH LICH LAM THIET KE 2 LOP,269000,269000,4,1,
0,0,Quan short kaki tui hop unisex,160000,160000,5,2,5
0,0,[FREE FIRE] Ao thun nam in hinh Free Fire cotton mau den Rank huyen thoai,88000,88000,4.5,13,21
0,0,AO BA LO NAM THE THAO VAT BAU NANG DONG,149000,149000,5,3,16
0,0,Ao thun nam Ao polo nam ngan tay co co PN03 Cotton 100% cao cap phong cach Han Quoc,125000,125000,3,1,1
0,0,"AO KHOAC DU NAM BOMBER UNISEX SIEU DEP,SIEU THOANG MAT",97000,97000,1,1,2
0,0,Quan jeans nam wash mau chinh hang DARNELL DN523,499000,499000,5,2,
0,0,"AO KHOAC KAKI NAM CUC CHAT PHONG CACH , SIEU XIN , CHAT , NGAU CHO ANH EM HQ 99 STORE",199000,199000,5,1,4
45000,75,AO THUN TRON OVERSIZE UNISEX mau NAU BO/NAU/TAN/XAM ️/Nam nu unisex ️,60000,15000,3.5,2,2
0,0,"Ao Ni Thun Nam, Ao Sweater nam phong cach Han Quoc- AN03",179000,179000,4,1,1
0,0,QUAN JOGGER PANTS NAM NU,109000,109000,5,1,1
0,0,quan tay den viet tien,495000,495000,5,1,1
0,0,"Ao so mi dui coc tay nam chat dui Li-nen tre trung, nang dong, mat me cho mua he nong buc",109000,109000,4,9,13
0,0,Ao khoac da lon lot long sieu mem min,500000,500000,5,1,1
0,0,Quan Short Jean Nam Chat Bo Co Gian️️Quan Dui Nam thoi trang cao cap (kem hinh that) To To Shop - QSJNM260,139000,139000,5,4,8
28000,50,Ao Thun Nam Mau Thun Tron Mac Nha Moi Lua Tuoi,56000,28000,2,2,20
0,0,"(MAC NHU KHONG MAC) Comb 4 quan lot Nam thong hoi thoang khi, Min Mat Nhu Lua (KEM HOP) - Quan sip dui",169500,169500,5,1,2
0,0,Ao khoac jean nam tron cao cap vai jean denim khong nong hang chuan shop Phuongnamshop20 rkv11,160000,160000,5,1,
0,0,AO THUN NAM DAI TAY,149000,149000,1.5,2,6
0,0,"BO PIJAMA NAM | DO BO MAC NHA NAM KHOE KHOAN SANG TRONG, BO COTTON MIN MAT",410000,410000,5,1,2
0,0,Ao Thun Body Ngán Tay Nam Cỏ Ngau Nhien 206377,58500,58500,2,1,3
0,0,Ao so mi ngan tay OWEN Bodyfit - BA22626NT,548000,548000,5,1,1
0,0,"Ao So Mi Dui Dai Tay Ghi CEFFYLO Chat Lieu Dui Nhe, Thoang Mat, Tham Hut Tot",350000,350000,4,1,1
0,0,Ao thun tay dai Titishop ATN168,263500,263500,5,1,
0,0,Quan Jean Nam Xanh Tron don gian form om chat Vai Jean Co gian skymen001,149000,149000,5,1,4
0,0,Ao hoodie tron ni day mau tim nhat purple hoodie unisex,89000,89000,5,1,2
0,0,"́ thun UNISEX OMBRE ̀ ̂ ̂́ AＮＨ ＴＨAＴ̂́ ̣̂ % cotton  ̂́, thoang mat",159000,159000,5,1,3
0,0,Ao so mi nam FEAER DENIM chat vai nhe thoang khi vai lua CAMERA MAN,279000,279000,5,1,1
0,0,Ao Sat Nach The Thao Nam Tap Gym - Chat Lieu Thun Lo Kim Cao Cap SZone SA108,69000,69000,3,2,7
0,0,Ao khoac hoodie unisex Asala HD-05-10,95000,95000,4.3,104,314
0,0,Quan Jean Nam Skinny Den Tron SZone SQ602B,149000,149000,5,3,4
0,0,Ao thun tay lo Wind phong unisex form rong DISOUT nam nu oversize ulzzang,70000,70000,5,1,3
0,0,Ao Len Trung Nien Lot Ni Sang Trong Sieu Am SAL240,249000,249000,5,1,6
0,0,Ao Khoac Free Fire Mau Den Logo Rank Huyen Thoai Co Non Hinh In Sac Net Du Size Danh Cho Ca Nam Va Nu,155000,155000,3.7,3,14
0,0,"Quan Short Jean Nam, Quan Bo Ngo Nam Cao Cap Mau Moi Sieu Dep OBOK Fashion QSN2040",149000,149000,4,1,3
0,0,Ao so mi nam form rong ngan tay hoa tiet song bien phong cach Han Quoc chat vai voan lua mem  min thoang mat bao dep,133650,133650,3.3,3,3
0,0,"Quan Short Nam, Quan Ngo Nam Vai Dui Mem Min Thoang Mat",79000,79000,5,3,4
0,0,AO SO MI NAM DAI TAY KHONG NHAN PHOI SOC,190000,190000,0,0,
0,0,"Ao Thun cho ca Nam va Nu Phan Quang In hinh THANH GIA , ao chat, di dem, di phuot bao ngau, nhin da mat",60000,60000,4,6,14
111200,44,"Ao so mi nam Julido, chat lua khong bai nhao khong xu long ton dang om form mau JL14",250200,139000,4.5,27,49
0,0,Jean Nam -quàn bò nam- Quan Jean Nam Ong Rong Phong cach mau trang,198000,198000,2,1,5
0,0,AO THUN NAM DAI TAY COTTON DEP,149000,149000,5,3,5
39500,33,Quan Short KAKI ngo Tui Hop Unisex - QS03,118500,79000,4.8,5,9
0,0,Homme La Rousse - Men's Faux Leather Jacket,3575000,3575000,4.8,4,6
75000,50,Quan short nam nu lung chun vai kaki chat dep,150000,75000,1,1,1
0,0,"BO PIJAMA NAM coc tay-Do bo nam bo he chat vai COTTON 100% day dan, thong thoang (607)",410000,410000,5,1,2
89000,50,Ao khoac nam nu ni ngoai hoodie tay phong tron,178000,89000,0,0,
0,0,AO KHOAC DA NAM CA TINH,369000,369000,5,1,
0,0,Ao thun NEEDS OF WISDOM Mini Embroidered Nowsaigon Tee,333000,333000,5,3,
0,0,Ao khoac gio lot long nam trung nien+ANH THAT,299000,299000,1,1,1
0,0,QUAN DUI XUONG NAM SLIMFIT MK04,195000,195000,4,1,3
0,0,Thun SWE PRICE TEE ANH THAT SHOP CHUP KEM,110000,110000,5,1,1
0,0,Ao So Mi Nam Tay Dai Du Size Nhieu Mau LV523,159000,159000,5,1,3
0,0,Ao Thun Nam Co Co Polo Tay Ngan Co Be Phoi 3 Mau Tron Thiet Ke Basic Cao Cap Big Sport ,249000,249000,4.2,5,20
96000,44,"Ao thun nam dai tay Julido, Chat thun cotton xin bo tay va hong mau thu dong X2222",216000,120000,3.8,11,27
0,0,"Quan Jogger Nam Dui co gian, chat day dan ko bai khong xu dang tre trung",191000,191000,5,1,1
0,0,"Ao Polo nam ngan tay co be Vien Tay, ao thun nam co be Moi AP003",89000,89000,5,2,3
73000,50,Do bo nam nu unisex mua he chat me xin co gian 4 chieu thoang mat (Surise),146000,73000,1,1,5
0,0,"AO MAY O NAM LA AO LOT NAM, AO 3 LO NAM, AO MAY O PHU HOP VOI BE TRAI LON, THANH NIEN, TEEN VA NGUOI CAO TUOI CO CAN NANG TU 50KG DEN 83KG vai 100% cotton thuoc BST CATRIO SUMMER 2021",59000,59000,3.7,3,41
0,0,Ao thun Teeworld Saigonese - The City That Never Sleeps T-shirt,329000,329000,5,1,4
159200,44,"Ao Khoac Chong Nang Nam, Ao Khoac Du Nam Nu Hai Lop Chong Gio, Ao Khoac Nam Thu Dong Cach Nhiet, Ao Khoac Unisex Phong Cach Han Quoc Thuong Hieu Chandi Ma NT338",358200,199000,4.5,25,33
0,0,"Ao Thun Nam Phan Quang In mat sharingan cua Uchiha Itachi -  anh hung tham lang lang La, anime Naruto , ao chat, di dem, di phuot bao ngau, nhin da mat",59000,59000,4.5,2,8
141000,32,Ao Ni Nam Lot Long Day Cao Cap AN04 - Ghi,440000,299000,4.5,2,2
0,0,Ao Ba Lo Nam Thun Cotton - Ao tanktop ba lo mua he cua nam form rong thoai mai van dong,69000,69000,3.5,2,6
144000,44,"Quan Sot Jean nam co dan 4 chieu Thuong Hieu Chandi, phong cach han quoc mau moi nhat 2021 MS097",324000,180000,4.2,9,20
0,0,Quan Lot Nam- Sip Cotton Soc Ngang Mem Mong Tham Hut Mo Hoi K146,38000,38000,5,3,11
0,0,CATSA Quan kaki theu,430000,430000,5,1,1
59000,50,Ao Thun Nam Phan Quang In Tee BOBUI Sai Gon Phan Quang - Ao thun BOBUI SaiGon Reflective Phan quang,118000,59000,1,1,2
0,0,Ao Thun Nam Nu tay ngan in hinh ATND1512,22000,22000,5,1,3
0,0,Ao khoac bo phoi chu Nothing Really jean nam tre trung nang dong ca tinh,165000,165000,5,1,1
0,0,Ao khoac jean nam cao cap phong cach han quoc nam tinh KJN1,245000,245000,4,4,6
0,0,Ao len nam co lo BS29D,250000,250000,3.3,3,13
199000,50,COMBO 2 AO THUN 3 LO RIP 100% COTTON 4 CHIEU FEZZIO ,398000,199000,4,1,1
199000,50,Ao gile nam om body mau xam chat lieu vai day min,398000,199000,5,2,3
200000,42,COMBO 4 QUAN NGU NAM THUN 100 % COTTON FEZZIO,476000,276000,4.6,42,93
121000,32,Ao khoac da lot long bo tay hahaman nam thoi trang cao cap AD77DEN mau den,380000,259000,4,3,5
0,0,Ao thun nam cotton tay lo form rong,79000,79000,2.1,9,17
0,0,Ao Khoac Kaki Nam Co Non Nam Tinh Phong Cach Han Quoc KA2,145000,145000,4.3,19,33
148000,49,"BO DUI NAM CAO CAP, HANG LOAI 1, SIEU NHE, SIEU MAT, 4 MAU",300000,152000,4.7,53,113
0,0, Hop 4 quan lot nam boxer vai Cotton cao cap Men's UnderWear,155000,155000,4,3,7
0,0,Ao Thun Nam Tay Dai Dep Mau Moi,149000,149000,1.3,3,5
0,0,Ao thun nam trung nien QAQA,132000,132000,1,1,7
0,0,COMBO 3 quan Dui Nam ,275000,275000,5,3,5
0,0, QUAN SUONG NAM ONG RONG - JN6640,169000,169000,2.5,2,3
127200,44,"Ao So Mi Nam sieu cap Thuong Hieu Chandi, chat lua khong bai nhao khong xu long ton dang om form mau SM13",286200,159000,4.1,9,31
0,0,AO THUN DAI TAY NAM TRON CO TIM,39000,39000,3.5,2,
0,0,Ao Thun Nam Nu tay ngan in hinh ATND1486,22000,22000,5,1,3
107000,43,"AO CHONG NANG NAM, CHAT LIEU VAI THONG HOI, CO MU, TAY DAI CHE KIN BAN TAY",250000,143000,4.1,51,112
0,0,QUAN LOT BOXER NAM ROSSO 0002 - UNDERWEAR,90000,90000,5,2,10
0,0,Nikafashion Ao Hoodie Non Unisex Nam Nu Chat Vai Ni Freesize 1 kich co Form Dang Rong Duoi 65kg Mac Dep HINH CHU.K,94500,94500,4,1,3
0,0,QUAN SOOC NAM 8BS20S012 CANIFA,379000,379000,4.5,8,18
0,0,Ao Thun Free Fire Mau Trang In Hinh Khung Long Du Size tu 29 - 99 kg Danh Cho Ca Nam Va Nu,80000,80000,0,0,
0,0,Ao thun tay lo Unisex Nomac in hoa tiet doc la Scariest Nitgh AT0708 / Freesize/ Phu hop ca nam va nu.,56000,56000,5,24,35
111200,44,Quan short jean nam B7777 co dan kieu dan tre trung don gian theu hoa tiet Julido thoi trang han quoc,250200,139000,4.8,17,26
0,0,"Ao Thun Nam Phan Quang Co Dang Ao Uninsex, Tay Ngan, Co Tron, Co Ao Thun Size Lon 2XL, 3XL, 4XL, XXL, XXXL, XXXXL",60000,60000,4.7,40,78
0,0,Ao thun Nam ba lo tap GYM the thao - AT021,110000,110000,4.7,10,47
0,0,Bo Quan Ao Dui Nam Trang Tron Dang Om SETTRANG99,169000,169000,4.5,13,37
0,0,Ao thun nam unisex phong rong hoa tiet sieu hot (UX-06-01),50000,50000,5,1,4
0,0,Ao thun tay lo Nomac Unisex doc la dep Fline Stone Bar AT0704/ Freesize/ Phu hop ca nam va nu.,55000,55000,5,16,21
91000,36,Ao khoac du gio nam chong nang co dung vien phan quang an toan tien loi truot nuoc nhe TKAKD36 PigoFashion nhieu mau,250000,159000,4.5,2,4
0,0,Quan dai kaki nam cao cap,195000,195000,4.2,9,21
23300,20,Ao POLO Nam KOLABA - Co Phoi mau Hien Dai Co Dan 4 chieu Thoang Mat Phu Hop Cong So PL02,118300,95000,1,1,6
159200,44,"Quan Bo Nam cao cap thuong hieu Chandi, chat jean co dan mau moi 2021 ma 110",358200,199000,5,35,49
0,0,"Ao Khoac Du In Hinh SWE Lego, Du 2 Lop Day Dan",300000,300000,3,1,4
0,0,Bo Quan Ao Thun Nam Ngan Tay In Hinh Tia Set- Bo He Nam Tay Co Trong Tay Lo Chát Thun Lạnh Co Dãn 4 Chièu,128700,128700,4.5,8,21
0,0,Ao khoac du nam cao cap vai du xin chong tham nuoc tot hang chuan shop Phuongnamshop kvo39,81000,81000,4,1,1
0,0,QUAN JEAN NAM PHOI CHU RACH GOI PHA CACH,189000,189000,1,1,2
3000,1,COMBO 4 QUAN NGU KATE COTTON TUI SUON FEZZIO ,312000,309000,4,2,9
0,0,AO NI HOODIE UNISEX Tom Jerry,169000,169000,1,1,2
0,0,Ao vest Titishop mau den​ AVN57,350000,350000,5,1,2
0,0,Ao So Mi Nam Tay Ngan Hoa Tiet The Shirts Studio Han Quoc TD42F2308,79000,79000,5,2,6
0,0,Ao Thun Co Tron Unisex Nam Nu Basic 19 Mau Big Size,189000,189000,5,25,154
160000,44,"Quan jean nam co dan 4 chieu QJ050 Julido Store, phong cach thoi trang hien dai mau moi",360000,200000,4.7,70,141
127200,44,Quan jean nam cao cap 4 chieu co dan King168 - hang chat luong LA012,286200,159000,5,9,18
0,0,QUAN JEAN NAM SUONG ONG RONG KHA BANH - MA JN017,199000,199000,4.8,4,10
71000,34,"Ao gio 3 KHOA, trang bac, chong tham nuoc, chong bui, chong nang ",210000,139000,2.7,3,10
0,0,Meo hoang thuong - Ao thun trang don gian in hinh Freesize,99000,99000,5,12,35
0,0,Quan au nam thoi trang Han Quoc KM21,165000,165000,0,0,
0,0,AO SO MI NAM ADAM STORE XANH KE BBR SDTKADT5-S,700000,700000,5,1,1
0,0,quan jogger linh nam,215000,215000,4.3,19,57
0,0,"Ao One Piece Luffy, ao thun One Piece 3D Den",175000,175000,4.6,16,94
0,0,Quan short kaki Q160 MuiDoi,95000,95000,5,1,1
0,0,Ao Thun Cotton Nam Den Free Size,129000,129000,4.3,8,106
6000,3,Ao khoac Kaki nam phoi day keo,195000,189000,3,1,10
0,0,Ao so mi nam tay ngan hoa tiet The Shirts Studio Han Quoc-TD11F2336BL,79000,79000,5,4,5
0,0,Ao Thun Nam Polo EnVyMEN AXD005 - Xanh Den,242000,242000,4.7,3,20
0,0,AO KHOAC DA NAM LOT LONG SITAKI - AD14 NAU,299000,299000,4,6,20
0,0,Ao khoac jean nam from rong va rach JB10,59000,59000,4.6,23,
0,0,Quan lot luoi nam sexy ho mong HP04 - 1 cai mau do,49000,49000,4.5,5,20
0,0,AO SO MI NAM CO TRUONG _PHONG CACH MOI,165000,165000,4.2,36,134
0,0,Ao khoac phao nam nu ( anh that ),265000,265000,2.3,4,31
151000,34,Ao khoac da nam bo tay lot long thoi trang cao cap Hahaman HABT01,450000,299000,4.2,23,45
0,0,"Quan Short Animated nam FEAER form suong thoai mai, Chat lua cheo",250000,250000,3,2,3
0,0,Ao Doi Nam Nu Du Lich Cao Cap (Gia 1 Ao),25000,25000,5,1,7
99500,50,AO THUN 3 LO  FEZZIO  NAM RIP  COTTON  BODY  GYM ,199000,99500,4,12,27
111200,44,"Quan short jeans nam , quan sort nam eo co dan tron rach lich lam san lai thiet ke phong cach thoi thuong loi cuon dao pho Julido mau JS0977885 thoi trang han quoc trung nien",250200,139000,4.5,5,27
40000,21,Combo 3 Quan Lot Nam Freeman 6018-CB3,189000,149000,4.8,6,132
0,0,Ao so mi nam co truong lich lam,165000,165000,3.3,24,369
0,0,"Ao khoac du nam GOKING mu dau sau co, 3 tui to da nang, chong gio nang bui, di mua hieu qua",255000,255000,5,5,5
0,0,"Ao thun tay lo Unisex MaiVuong, ao phong form rong MONTH402",79000,79000,5,4,10
0,0,Quan dui nam dai ong suong,170000,170000,5,1,3
0,0,Bo Vest Cao Cap Dang Slim Fit Mau Ghi 1 Cuc HDT023,1449000,1449000,3,1,1
0,0,"COMBO 3 Ao Thun Nam Sat Nach co Big Size, thun lanh cuc mat",159000,159000,1.5,2,2
61000,28,Bo 3 Quan lot dui Boxer nam thun lanh cao cap thoang mat Pigofashion QLPG03 ( mau ngau nhien),220000,159000,4.8,4,20
61000,44,Quan the thao nam chat dep vai mat tui khoa keo Pigofashion QTTN01 mau den soc trang,140000,79000,4.3,3,7
61000,27,Combo 5 quan lot tam giac nam mem min thoai mai khi mac TKCB5QLPG01 PigoFashion mau ngau nhien,230000,169000,4,1,5
0,0,BO QUAN AO THUN NAM DAI VAI DU THU DONG,299000,299000,5,1,3
0,0,"Quan lot nam Thong Hoi nhat ban, quan boxer nam Luoi HM (Hop 4 Chiec)",95000,95000,1,1,1
0,0,Quan Jogger The Thao Elohim Phan Quang,425000,425000,1,1,
0,0,Over Bobui 12 Angel - Tee Bobui 12 thien than,298000,298000,4.3,3,40
0,0,HOT ao thun tay lo Pepe Frog dep gia cuc re,93600,93600,5,1,
0,0,"Ao so mi nam dui Li-nen coc tay (SMD119), ao dui thoi trang phong cach Han Quoc",234000,234000,4,2,3
0,0,Combo 2 Ao thun 5THEWAY Tay Ngan Form Moi Den aka 2 PACK 5TW/RTW NEW TEE in BLACK TEE,500000,500000,5,3,3
0,0,"Quan lot dui nam thun lanh QMEN, quan boxer nam khong duong may khong vien cao cap",36000,36000,1,1,12
43000,43,"Combo 2 Quan Lot Nam Boxer Thun Lanh Lung Thai Cao Cap, Quan Sip Dui Co Gian 4 Chieu CITYMEN ( Mau Ngau Nhien )",99000,56000,5,1,2
0,0,"DeremonStyle - Ao khoac Jeans Nam nu unisex in chu ca tinh, doc dao - Hot New 2021",159000,159000,5,1,1
0,0,Quan dui shorts 2in1 bo dui trong Pmax mau hot hit,129000,129000,4.6,21,42
0,0,"Quan tay nam, quan au nam, quan tay nam Han Quoc - Quan tay nam SQOXDSL",280000,280000,4,1,1
0,0,Ao thun doi cho cuu ho Chase tre em | Ao Paw Patrol Chase tay ngan cho be trai| be gai dep PA07 | Ao Chat Store,0,129600,4.5,2,
0,0,AO KHOAC NI NAM PHOI THAN,199000,199000,4,2,2
0,0, Quan sip quan lot nam thun lanh doremon hang hieu,22000,22000,5,5,18
20000,13,AO KHOAC DU NAM HAHAMAN 2 TRONG 1 CHUYEN DOI THANH BALO CHONG THAM SIEU NHE AKD011,155000,135000,5,1,
0,0,"Bo Scrubs bac si NAM cao cap mau Xanh Den - Quan ao Blouse ky thuat vien, ho ly, dieu duong, do truc phong kham, benh vien",290000,290000,4.5,2,4
450000,20,Ao khoac long vu Aligro ALGALV.16,2250000,1800000,4.7,3,5
0,0,Quan short kaki nam tui hop nhieu mau chat lieu kaki chuan VNXK (50 - 85 kg) - Q010,185000,185000,4,1,
0,0,Quan Short Nam Thun Cao Cap Thoi Trang Mau Den - Xam TC03735,149000,149000,2.3,3,8
0,0,Quan kate nam,75000,75000,5,1,2
0,0,"Ao Thun Nam Phan Quang In hinh Kakashi , ao chat, di dem, di phuot bao ngau, nhin da mat",60000,60000,4.8,10,20
0,0,Quan short Kaki nam ngan Santino chat lieu cotton cao cap co dan nhe thoai mai dang xuong thoai mai SRG385A105,385000,385000,5,1,2
0,0,Quan dui Nam chat lieu mat thoang,130000,130000,5,1,1
127200,44,"Ao ba lo nam/ 3 lo nam cao cap, soi cotton mem min sieu thoang mat, tham hut mo hoi cuc tot, co dan 4 chieu chandi M115",286200,159000,4.5,8,12
127200,44,"Ao Thun Nam Ngan Tay Thuong Hieu Chandi, Chat Thun Cotton Xin Mau Moi NH21",286200,159000,5,4,47
0,0,Ao khoac ni lot long cao cap AKNLL001,175200,175200,5,1,
127200,44,"Ao ba lo nam/ 3 lo nam cao cap, soi cotton mem min sieu thoang mat, tham hut mo hoi cuc tot, co dan 4 chieu chandi MA93",286200,159000,4.6,11,17
0,0,"Ao thun nam co tru thoat nhiet Nhat Ban GOKING, sieu thoang mat, hang cao cap xuat khau",214000,214000,5,23,56
125000,39,"Ao khoac nam AK Corner co dung, kaki 2 lop day dan, thoang mat, co tui truoc nguc, tre trung",320000,195000,5,3,5
91000,48,"Combo 4 Quan Lot Nam Boxer Cotton 4 Chieu Lung Thai Cao Cap, Quan Sip Dui Nam Thoang Mat - ( Giao Mau Ngau Nhien )",190000,99000,5,1,7
0,0,"Quan lot su nam, quan lot nam sexy thoang mat LN065",76000,76000,4,1,3
0,0,Do bo Gym nam mau 3 lo phong cach bong ro chat thun tham hut mo hoi cuc tot DB22,79000,79000,5,1,2
0,0,Ao thun unisex in TOM & JERRY sieu de thuong form rong vai day AT78,25000,25000,5,1,2
0,0,Ao Hoodie Nam Nu Vai Xin Sieu Day Phan Quang Essentials,148000,148000,5,1,6
0,0,Quan shorts Nam di bien vai du sieu mong  - A057,180000,180000,5,2,9
0,0,"AO KHOAC HOODISES NAM NU,MAU SAC SINH DONG,CHAT LIEU VAI THOANG MAT",97000,97000,5,1,1
0,0,Quan jogger BO CHUN RUT GAU 3 SOC the thao unisex N7 nam nu ong rong hiphop bigsize thu dong basic pants,189000,189000,4.6,10,23
0,0,Ao phong Dinosaur,76000,76000,5,2,4
0,0,HOT - Ao phong game Dai Chien Nguoi Que - Stick war cuc chat,108000,108000,5,1,1
0,0,Quan Du Tui Hop Streetwear Cao Cap FNOS Mau Den 2 Lop - Ong Rong - Co Day Rut Chan.,500000,500000,4.5,2,2
0,0,Ao thun tay lo LUNACY in phan quang phong Unisex nam nu Cotton oversize form rong LUNACY,119000,119000,5,2,2
0,0,"Quan Khaki Tui Jeans tron Xam Dam CEFFYLO, Form Slimfit, Co Gian",390000,390000,1,1,
0,0,"Quàn short nam thẻ thao thuong hiẹu TORANO BW088, vải gió mèm, sieu nhẹ, co giãn tót",199000,199000,5,1,7
0,0,Bo Quan Ao Linh My US ARMY Ran Ri Tui Hop Chien Thuat [Tang That Lung],0,449000,3.5,2,
0,0,"Ao thun nam co be vai ca sau, combo 3 ao - EZ340",410000,410000,5,1,
0,0,Combo 3 quan lot nam goi cam  chat thun coton lanh cao cap cho chang ,160000,160000,4.5,12,58
0,0,Ao phao nam AN164,399000,399000,0,0,1
0,0,BO DO NAM AO BA LO QUAN NI CO GIAN TOT,249000,249000,5,1,2
0,0,Quan tay nam cao cap form chuan LAVIC 327,259000,259000,5,1,1
0,0,Ao so mi nam viet tien dai tay mau hong lat,350000,350000,5,1,2
0,0,Ao khoac gio nam dep AN172,350000,350000,3.7,10,23
0,0,Ao giu nhiet - Ao giuu nhiet,55000,55000,4.5,9,43
0,0,"ao so mi nam - hoa tiet moi la, form rong, lua chon so 1 cho cac MEN (D1)",169000,169000,5,1,2
0,0,Ao Thun Nam Co Tron 100% Cotton - Ao Thun Nam Ngan Tay ,139000,139000,5,3,4
0,0,"- Quan short nam chat ni da ca mem min Kaba, quan dui nam phong cach the thao 6 mau",72000,72000,2.5,2,7
0,0,Ao So Mi Nam Cao Cap (SM-76),69000,69000,3.3,6,17
0,0,Quan jean nam - KLS733,199000,199000,5,1,1
0,0,Quan lot nam tam giac Hunk Ultimate Pouch Brief tui Kangaroo kep Den -  H16,129000,129000,5,3,48
20000,34,Quan lot nam Roman lung nho - Chat lieu thun lanh silk 4 chieu cuc mat.,59000,39000,5,1,7
0,0,Bo 2 quan lot nam lung bang lon cotton 4 chieu cao cap SIP RM 2x502,69000,69000,5,1,2
0,0,"Ao thun nam phong tron Casual 1st co tron tay ngan coc, vai 100% cotton cao cap thoang mat, tham hut mo hoi, form ao tre trung thich hop di lam, di choi, dao pho, du lich, Made in Vietnam - HappyHolidays",250000,250000,5,1,1
0,0,AO THUN NAM NGAN TAY CO TIM TRON NHIEU MAU,119000,119000,5,1,18
0,0,Ao khoac Jean Nam Nu Unisex Chollima mau Den co mu,249000,249000,4.7,57,102
0,0,"quan tay nam ngan , quan au short thoi trang Faja",105000,105000,4.2,34,136
0,0,Ao Thun Nam Ba Lo Tank-Top Sat Nach Tap Gym Vai Det Kim Co Vien Tham Hut Mo Hoi Cao Cap Big Sport,139000,139000,4.8,38,149
0,0,Ao so mi nam Mau Xanh Nhat ASM01,65000,65000,4,2,4
101000,51,Ao so mi body nam caro cao cap ngan tay Hahaman HM01,200000,99000,4.5,13,23
0,0,"Quan Jogger Ni Tron Unisex ,Quan Thun Ni Dang Rong Ong Bo 2 Mau C002 - zeni69 store",110000,110000,5,1,1
0,0,Ao Thun Nam Everest AokNAM401 - Trang,235000,235000,4.2,21,499
0,0,Ao Thun Nam In Hinh Gau Truc Panda Everest AoKNAM30 (Trang),225000,225000,4.5,59,810
0,0,Ao thun nam in hinh HATE MONDAY LOVE FRIDAY KM501,180000,180000,4.5,16,32
0,0,Ao Thun Nam Everest AokNAM411 - Trang,260000,260000,3,7,55
90000,32,"So mi nam tay ngan Amazing, vai bamboo ke soc, dang truyen thong, vai mem min tham hut tot - 01",279000,189000,3.8,4,10
0,0, Quan Lot Chay Bo Nam T8,430000,430000,5,1,3
0,0,Ao Thun Marshall Vintage - Chinh Hang,600000,600000,5,1,2
0,0,BO DO NI COTTON THU DONG NAM DAI DAY AM,269000,269000,4,1,4
0,0,"(Hang Cao Cap) Ao Gio Pmax, 1 Lop, Vai Xin co dan, Mac Cho Ca Nam Nu, Chong Nuoc, Chong Gio, Chong Nang, Phom Tre Trung",239000,239000,4.6,11,14
0,0,Ao Khoac Du Nam Co Non lot den cuc chat ASALA (AK-135),69000,69000,4.5,20,172
0,0,"AO KHOAC DU NAM FORM RONG 2 LOP PHOI MAU DI MUA,CAN GIO, CHONG NANG DA NANG TA3979 ",67000,67000,5,5,15
0,0,"Sip Dui- Quan Lot Nam Boxer Cotton Hoa Tiet Tre Trung, Hot Trend K451",65000,65000,5,8,11
0,0,"Ao thun tay lo,ao thun unisex nam from rong ATZ24",109000,109000,0,0,
0,0,Combo 4 Quan sip dui nam thun lanh Doremon boxer nam hoat tiet nhieu hinh cuc hot Micado,119000,119000,4.5,2,14
0,0,"SET BO THU DONG UNISEX DANH CHO NAM NU , CUC HOT THOI TRANG LANO STORE",135000,135000,5,1,2
0,0,Ao vet nam cong so ao vet dep uy tin,469000,469000,3.7,3,8
0,0,Ao so mi nam tron tay dai ,89000,89000,2.1,16,213
56000,11,Combo 5 Quan Lot Boxer Nam Freeman 6512-CB5,495000,439000,5,1,2
0,0,Combo 3 Quan Lot Nam JME JM531,129000,129000,4.2,10,123
0,0,Quan Au Nam Den Dang Body DEN01,150000,150000,4.1,13,129
0,0,Ao So Mi Nam Tay Ngan Hoa Tiet The Shirts Studio Han Quoc TD45F6157BK,69000,69000,4,5,22
0,0,Ao So Mi Nam Tay Ngan Hoa Tiet The Shirts Studio Han Quoc  TD42F2121VI,79000,79000,3.8,5,30
0,0,"Xet quan ao squid game Miuzi,Bo quan ao tro choi con muc kem ao Phong ben Trong",79000,79000,5,1,6
0,0,Bo do nam giu nhiet Ohazo,600000,600000,3.8,6,27
0,0,quan short tay au cao cap V&N,65000,65000,4,1,5
0,0,Combo 2 Ao thun 5THEWAY Tay Ngan Form Moi Logo Den aka 2 PACK 5TW/RTW NEW TEE in BLACK LOGO,500000,500000,5,1,10
0,0,Quan jeans nam LB co gian rach goi ca tinh DNHQ009861,175000,175000,4,1,8
0,0,Quan Kaki Nam Cao Cap 2020 QK040 tang Moc khoa,114000,114000,4.5,2,
0,0,Bo Quan Ao Linh My Thuy Quan Luc Chien,0,799000,4.3,4,
0,0,Quan jogger nam Simple & Basic sieu nhe,299000,299000,5,1,1
0,0,Bo vest nam Han Quoc mau ke caro dep - DUKI STORE,699000,699000,5,3,4
0,0,Ao so mi cap doi nam nu hot trend xu huong tinh yeu Han Quoc-gia 1 ao,85000,85000,4,2,5
0,0,Quan Ni Nam Thu Dong Cho Bo,75000,75000,5,2,10
0,0,[Co VIDEO + ANH THAT] Ao sweater - Ao ni tay dai UNISEX N02,148000,148000,5,2,2
0,0,Ao So Mi Nam Tay Ngan Hoa Tiet The Shirts Studio Han Quoc TD42F2113BL,79000,79000,5,4,20
40000,18,"Ao so mi dui nam co tru dai tay 4 khuy nguc xanh duong LAHstore, thoi trang phong cach Han",219000,179000,3.5,4,15
40000,19,"Ao len nam co lo ArcticHunter, chat len mem min, thoi trang tre, thuong hieu chinh hang",209000,169000,4.1,20,54
40000,26,Quan jogger thun nam 1 soc lon QJT09,155000,115000,4,2,12
60000,17,"Ao vest Blazer Linen nam dang lung LAHstore, thoi trang phong cach tre trung",350000,290000,5,1,4
94500,50,SHORT THUN FEZZIO SPORT ACTIVE CHINH HANG,189000,94500,5,1,6
0,0,Quan Short Teelab Basic Draper PS017,195000,195000,5,1,1
0,0,combo 4 quan sip quan lot nam full hinh thun lanh hang hieu,122000,122000,0,0,
0,0,AO SO MI NAM DAI TAY HOA TIET 3D THO CAM CAO CAP,169000,169000,1,1,
0,0,Quan kaki tui hop kieu linh cao cap,219000,219000,3.9,31,121
0,0,Bo 3 ao thun body co tron nam Taki Taki (Trang - Xam Ghi - Den),165000,165000,4,22,60
0,0,Ao polo ngan tay Nam Beverly Hills Polo Club Regularfit Cotton Navy PMRSS20TL097,990000,990000,5,2,2
0,0,Quan jean nam rach cao cap vai co dan hang quang chau PHUONGNAMSHOP cao cap kv10x,136800,136800,0,0,2
0,0,Quan kaki nam tron basic cao cap vai kaki xin hang xuat du Phuongnamshop20 z33,136500,136500,2,2,4
0,0,Quan The Thao Nam Den Soc Dang Om SOCLUNG03,125000,125000,0,0,1
0,0,"Bo The Thao Nam Chat Ni Han Quoc, Tay Soc Nang Dong, Thoai Mai",185000,185000,5,3,5
0,0,"Ao So Mi Nam Caro Tay Ngan Cao Cap Cotton Spandex Vai Mem Min, Khong Nhan, Mac Thoang Mat De Phoi Do - T1954 - 1",295000,295000,3.7,9,13
91000,36,"Ao khoac kaki nam HAHAMAN mot lop day, mem thoi trang cao cap AKK3009",250000,159000,4.8,9,12
33000,50, Ao Thun tron nam Unisex nhieu mau cotton co tron cuc chat,66000,33000,0,0,4
0,0,Ao choang cosplay Attack on titan doc dep,199000,199000,5,1,3
0,0,Quan sip dui xuat NHAT( chuan loai 1),29000,29000,5,1,7
0,0,"Ao polo nam , co det bo len ,ao thun nam co co tay ngan thanh lich POLO-26 - Soha Clothing",199000,199000,4.7,3,7
0,0,"Combo 2 ao ba lo nam/ao 3 lo nam, mem min sieu thoang mat, tham hut mo hoi cuc tot, vai thun lanh co gian 4 chieu ",198000,198000,4.6,11,33
220000,31,"Ao khoac blazer da nam dang dai 2 tui cheo ArcticHunter, thoi trang tre, phong cach Han",700000,480000,4.5,25,68
0,0,"Ao khoac teen cho nam va nu, form suong unisex, phoi 3 mau thoi trang, vai du nhe",189000,189000,4.7,25,129
0,0,Quan tay nam cao cap dang om cong so,108000,108000,3.8,4,35
80000,33,"Ao Gio 2 Mat Pmax, 2 Lop, Mac Cho Ca Nam Nu, Chong Nuoc, Chong Gio, Chong Nang, Phom Tre Trung",239000,159000,5,10,16
0,0,"AO KHOAC DU , AO KHOAC DU NAM CUC CHAT , CO MU CHE NANG SIEU DEP NGAU NHAT 2021 THOI TRANG NEMO36 STORE",79000,79000,2,1,1
0,0,Ao Dong Phuc Dau Bep Mau Den Tay Ngan,97000,97000,5,2,6
36000,14,Combo 3 Quan Lot Boxer Nam Freeman 6516-CB3,255000,219000,5,9,63
0,0,Ao khoac len nam hang cao cap AL04,249000,249000,4,1,
0,0,Ao phong nam - ao thun nam co co dep tay ngan cao cap thoi trang,247000,247000,5,1,
0,0,Quan Tay Au Nam Loai Vai Day Co Dan Om Body,119000,119000,5,1,2
0,0,Quan Sot Kaki Nam Dep Ben LD57,55000,55000,3.7,6,43
0,0,Quan short kaki nam lung thun sai 28--34,49000,49000,5,2,7
0,0,"Ao Khoac Nam , Chat du lot long cuc am",195000,195000,4,1,3
0,0,Sip Duc Nam Lua Sua Cao Cap 2019,110000,110000,0,0,1
135000,45,"Quan jogger nam tui hop, chat gio du mem min phong cach duong pho K06",300000,165000,5,3,11
0,0,"Ao So Mi Nam LAVIC-523 vai Lua thoang mat, khong nhan form suong",99000,99000,0,0,4
155000,50,"Quan Dui Nam Cao Cap Guzado, Chat Gio Mem, Co Gian 4 Chieu, Phong Cach Tre Trung Nang Dong GSR06",310000,155000,3.7,9,35
0,0,"[BigSize] Quan Short Nam (70-95kg) Lung Thun Co Dan, Chat Kaki Mem Mat in Hinh Hoa Tiet Thoi Trang Cao Cap Nam Minh",119000,119000,3.7,6,9
0,0,Ao thun hoat hinh xe tang dai chien cuc de thuong - co size tre em,115700,115700,5,1,6
0,0,Quan Jeans Teen Nam [Denim cotton USA] chinh hang RIOMIO - RM003,359000,359000,4.7,3,4
0,0,"Quan jogger nam nu 3 soc form ong rong rut day bo gau chat vai dep mem min mat co gian khong xu,quan the thao",135000,135000,5,1,3
0,0,"Quan Baggy Nam AROTI Ong Suong Rong Vai Cotton Lua Dep Cao Cap,Co Gian Dang Au,Cap Chun,Mau Den,Tien Mac Di Hoc QV46-B",280000,280000,4,1,3
0,0,Sieu Hot va Mat cung ao Ba Lo Linh Ran Ri Tanktop Army Camo Chat Cotton 100% xin xo,59000,59000,5,2,4
0,0,"Ao Thun Nam_ Nu  Phan Quang In hinh MAT MANG , ao chat, di dem, di phuot bao ngau, nhin da mat",60000,60000,4.3,14,29
70000,48,"Ao chong nang KE CARO NAM 2 lop vai day dan, sieu mat, chong nang tot",145000,75000,5,1,1
220000,31,"Ao khoac blazer da nam dang dai 2 tui cheo ArcticHunter, thoi trang tre, phong cach Han",700000,480000,4.2,31,79
0,0,Quan short tho hoa tiet phong cach Nhat danh cho nam chat lieu thoang mat,159000,159000,4.2,13,26
0,0,"Combo 3 Chiec Quan Lot Nam Boxer Det Lien Cao Cap, Co Dan 4 Chieu, An Toan, Than Thien Voi Lan Da CALUCI CBX 12 (Giao Mau Ngau Nhien) - Hang Chinh Hang",315000,315000,4.8,21,31
0,0,AO THUN NAM co be theu kim tuyen truoc nguc ,100000,100000,5,5,12
0,0,BO PIJAMA NAM CAO CAP QSHOP QM190,320000,320000,3,3,4
50000,42,Ao chong nang THONG HOI NAM vai KIM CUONG,119000,69000,5,1,1
0,0,AO CHONG NANG NAM 1 LOP NHO GON thiet ke chong tia UV,131500,131500,5,1,1
0,0,Quan Jogger the thao nam,169000,169000,5,3,16
0,0,"Ao Gio nam thiet ke 3 khoa trang bac, chong nuoc, can gio, giu am tot",139000,139000,4,1,2
23000,37,Ao giu nhiet nam lot ni - Co gian - Thoai mai - Am ap,62000,39000,4,1,2
0,0,Ao thun nam co co - xanh den,117810,117810,1,2,3
0,0,Xa don gan cua ban to tich hop thuoc do can bang,259000,259000,3,1,1
0,0,Quan kaki tui hop nam chat kaki tot size M L XL,95000,95000,0,0,
0,0,Ao thun ba lo chat cotton nam,75000,75000,3.9,7,6
0,0,Ao sweater ao chui dau ao hoodie xe ta cat ni ngoai size M L XL,75000,75000,4,3,5
0,0,"Set quan dui ao ngan tay the thao nam thun cotton co dan, thoang mat FASHION",80000,80000,5,1,3
0,0,Ao Hoodie Ni Tron Unisex ( Nam/Nu) Vai Mem Min,72000,72000,5,1,1
0,0,"AO KHOAC NAM FORM RONG UNISEX, DANH CHO CA NAM NU PHONG CACH HAN QUOC",137000,137000,5,1,3
21000,38,Quan sip quan lot nam full hinh thun lanh ,55000,34000,4.7,3,4
0,0,"Ao Khoac Di Nang, Chong Nang Co Mu Cho Nam CN11-Cotton Thoat Mo Hoi - Ghi sang - XL",119000,119000,0,0,183
0,0,"Quan Jogger nam Kaki loai dep, quan nam gia re QN006",83000,83000,1,1,14
0,0,Ao so mi ca ro phoi non unisex SM1,84000,84000,4,5,34
0,0,Ao hoodie Unisex NR,95000,95000,5,2,3
0,0,"Ao thun nam ba lo phan quang the thao co tron , ao TankTop nam nu form rong sat nach tap gym co gian mua he thu dep, ao thun phat sang 3 lo in hinh chu gau in chu FCRTSAT ca tinh phong cach han quoc",75000,75000,4,3,3
55000,37,Quan 1 soc ong suon nam nu vai ni cotton day min,150000,95000,4.3,4,22
75000,44,Quan thun Caro Nam Nu  Unisex mau DEN ong suong VIEN TRANG ,170000,95000,3,1,1
150000,42,"Combo 2 quan short jean nam cao cap form chuan dep, khong phai mau, do co gian tot mac thoai mai - Xanh den dam va xanh nhat",360000,210000,5,1,5
0,0,Ao hoodie tron ni day mau xanh reu basic hoodie unisex,85000,85000,4,1,
0,0,Ao Hoodie - Ao Khoac Ni Bong ORIGINAL Form Rong Nam Nu Unisex Couple Ulzzang,100000,100000,4,1,1
0,0,AO SWEATER TRON,78000,78000,3.8,8,38
0,0, Quan Ao Linh My US ARMY Gia Re - Quan Tui Hop Nam Ran Ri Kieu Linh,499000,499000,5,2,3
0,0,QUAN SHORT AU NAM - Kem - 29,135000,135000,0,0,19
0,0,Quan kaki baggy nam ong con cuc chat,81000,81000,4.3,8,21
0,0,quan zip 2 soc trong ngoai - rtpz,125800,125800,5,1,3
0,0,Ao Hoodie Ni Bong Tron Mot Mau Ca Tinh Phong Cach Han Quoc Nang Dong - LZGV016,86000,86000,3.3,3,7
105000,50,"Quan tui hop nam nu unisex dan gau chat kaki min, dep, cuc chat (hopdangau)",210000,105000,4.8,6,11
0,0,Ao Khoac Nam Da Thai Lot Du Phoi Keo AK95 (den),339000,339000,4.6,22,46
0,0,Ao Hoodie  Phong Cach Nam Mau Tron De Mac - FMGV16_05,72000,72000,4.2,46,129
0,0,"Quan short jean nam co BIG SIZE (den 100kg), quan ngo BIGSIZE cao cap, chat co gian nhe - NH Shop",119000,119000,4.6,7,28
0,0,BO QUAN AO THE THAO BO MAC NHA,105000,105000,4.5,2,4
0,0,"Ao thun phan quang 7 mau in VUI LONG DUNG XA 2M de thuong dang hot,Ao Thun Phan Quang 7 Mau Tay Lo Unisex Sieu Hot",100000,100000,5,1,2
0,0,  ao khoac du uinsex ️ (video+anh that) A95 ( co form rong XL ),120000,120000,0,0,
0,0,"Ao Hoodie Ni Bong Unisex Streetwear Luc Lang ( unisex nam nu deu mac duoc) ao hoodie nam nu, ao hoodie nu, ao hoodie nam, ao hoodie ulzzang, ao hoodie unisex",113000,113000,4.5,4,9
0,0,Ao thun tron den trang nam nu co tron tay ngan  Ao thun unisex du size chat vai day min co dan 4 chieu,77350,77350,4,2,8
0,0,"Ao thun nam den co co King168 , ao phong tiet hoa nam cao cap MS505",79000,79000,5,1,2
26700,30,quan lot nam Hunk anatomic Brief do ruou go tre Uc,89000,62300,4.7,77,583
61000,34,Ao thun THE 1992 cao cap Ao phong nam cotton basic,180000,119000,5,1,3
0,0,Ao thun nam dai tay thoi trang,69000,69000,5,1,1
0,0,AO KHOAC  HOODIE NAM  NU  ELXPREO MAU  HOT ,139000,139000,4.3,76,497
20000,20, Ao thun nam ngan tay co tim cotton thoang mat FREEMAN TSF315,99000,79000,4.3,3,10
0,0,Ao khoac jean nam hoa tiet cao cap vai jean denim khong nong hang chuan shop Phuongnamshop20 rkv1,160000,160000,3.7,3,9
165000,50,Ao Thun Nam Polo Co Be Guzado Chat Coolmate Mat Lanh Tham Hut Cuc Tot Kieu Dang Basic Form Regular Fit GPL01,330000,165000,4.5,7,23
50000,36,QUAN SHORT NAM THUN 100 % COTTON FEZZIO CO TUI,139000,89000,5,11,37
0,0,"Ao len nam co tron phoi mau co ban ArcticHunter, thoi trang phong cach Han",199000,199000,3.3,3,7
0,0,Ao So Mi Nam Ngan Tay Phoi Tui Hop Thoi Trang Cao Cap PONIVA Chat Vai Cao Cap Mem Mai Tham Hut Mo Hoi,125000,125000,3,3,4
81000,45,Ao phong nam ao thun polo nam ngan tay co co phoi bo TKAHT06 PigoFashion chon mau,180000,99000,5,2,12
0,0,Quan Jean Nam chat bo ️️ Quan jean nam cao cap co gian phoi bo chan bo lung mau moi 2021 To To Shop - JN61,169000,169000,5,4,20
0,0,Quan Jean Nam Phoi Rach ️️ Quan Bo Nam Thoi Trang Cao Cap Chuan Hang Shop To To Shop - QJNTT-ma 31,169000,169000,4.7,3,6
14500,32,Ao thun tron nam form rong phong cach han quoc vai poly cotton min Nhieu mau du size SIEU SALE !,45500,31000,4.7,3,33
0,0,AO KHOAC DU NAM BOMBER UNISEX,97000,97000,3.5,2,5
0,0,Ao Thun Nam Ngan Tay Co Co Phoi Mot Soc Thang Thoi Trang Han Quoc Moi Chat Vai Khong Xu Khong Phai Mau,105000,105000,5,1,2
0,0,Ao nỉ SWEATER DREW HOUSE mat cuoi Ao ni sweater unisex nam nu form rong oversize chat lieu Cotton,123000,123000,0,0,
41000,34,Ao dui nam THE 1992 Ao linen coc tay co tau,120000,79000,4,9,28
41000,34,Ao dui nam THE 1992 Ao linen coc tay co tau,120000,79000,4.3,6,10
0,0,QUAN KAKI NAM TUI MY VIEN  DANG SUONG DEP,150000,150000,5,1,2
0,0,ao polo ngan tay co co cotton- ao lo tay sieu dep - hottrend 2021 - mang dam phong cach han quoc-A1,99000,99000,4,1,1
0,0,"BO QUAN AO THE THAO MAC NHA, THOI TRANG NAM NU",65000,65000,4.3,28,68
0,0,Ao Khoac Nhe Nam HOODIE Thu Dong In Hinh Phong Canh Co Mu Trum Dau Hot Trend 2020 Thoi Trang,129000,129000,4.6,88,181
0,0,Quan Tay Au Caro Sang Ong Con,135000,135000,4.5,2,2
0,0,Ao Thun The Thao Nam ADIDAS - FM6016,1200000,1200000,5,2,5
0,0,Quan Jeans tron Xam nam form slimfit CEFFYLO chat Jean thun co gian nhe,550000,550000,5,2,2
0,0,Ao HOODIE ni lot bong in hinh cuc xin Form rong Unisex NAM/Nu cuc chat (Hinh that cua shop 100% ),155000,155000,4.7,3,6
0,0,Quan dui dui nam,104000,104000,5,1,4
0,0,Ao thun polo nam co co be phoi soc ngang vai vai ca sau cao cap ND02,159000,159000,4.5,35,113
0,0,Quan short nam the thao May 10 ma 160120159 8,246000,246000,5,1,5
0,0,Ao so mi lua nam hoa tiet cham bi,249000,249000,4.7,3,4
274000,46,Quan jeans nam RockStar  trung nien tui cheo ong thung chat dep mem min khong phai mau- Mau xanh dam,599000,325000,4.5,2,7
0,0,AO KHOAC DA NAM LOT LONG CA TINH,369000,369000,1,1,3
0,0,"AO THUN , AO PHONG FORM RONG NAM NU CUC DEP - HOT CHAT - SIEU BANH",85000,85000,0,0,
0,0,Quan jean nam den tron,179000,179000,2.8,4,6
0,0,Ao thun Oversize Trang Tron Form Rong Tay Lo Unisex Streetwear - Den - M,238000,238000,5,1,1
0,0,Ao Khoac KaKi Nam Day Dan Khong Xu Long,220000,220000,3.2,11,48
0,0,Quan tay baggy nam Han Quoc ong suong thanh lich - QUAN SM066C4,99500,99500,1,1,1
0,0,"Quan dui nam mac ngu King168, Chat dui chinh pham mac mat mau TOP1",39000,39000,2.5,2,11
0,0,"Quan jean nam cao cap thoai mai khi su dung King168 , quan jeans nam ong suong Q37",0,160000,5,2,
0,0,"Ao khoac nam King168 , ao khoac du nam cao cap NT890",0,220000,5,1,
0,0,"Ao khoac du 2 lop kieu dang the thao cao cap nam nu King168 , ao khoac chong nang thoi trang cao cap nam nu V58",0,149000,5,1,
0,0,Quan jean nam King168 jean nam cao cap D29,0,159000,5,1,
0,0,"Ao thun nam King168 , ao thun nam 3 lo vai cotton co dan khong xu TT12",0,100000,1,1,
0,0,Ao khoac jean nam King168 cao cap AK01,0,250000,1,1,
0,0,AO THUN NAM DAI TAY DEP,83000,83000,4.7,7,21
40000,31,QUAN SHORT KATE SPANDEX FEZZIO CHINH HANG FZ-05 NEO,129000,89000,5,2,12
14000,44,"Ao thun nam co tron cotton- ban le gia si -in nhieu 8 mau moi tre trung, phong cach thoi trang",32000,18000,5,2,4
0,0,Ao So Mi Nam Den Tron DENBE99 (Den Be),99000,99000,1,1,2
0,0," Bo The Thao Loang Mau Chat Thun Lanh Mem Min, Khong Ra Mau (in chu A)",75000,75000,0,0,
0,0,Ao hoodie Blackpink ,145000,145000,3.2,5,26
170000,49,"Ao so mi nam dai tay hai mau den trang, chat vai cotton cao cap chong nhan",350000,180000,4.7,6,19
0,0,"Quan short nam chat jean King168 , quan short jean nam cao cap SJN02",0,150000,5,1,
0,0,"Bo thun nam King168 , do bo nam cao cap THU34",0,150000,3,2,
0,0,"Ao khoac dep loai xin thoi trang nam King168 , ao khoac kaki nam cao cap MS573",0,149000,5,1,
0,0,Ao thun unisex nam  from rong 1S3 2Bi﻿,89000,89000,2.5,2,2
0,0,Ao So Mi Nam SM145,210000,210000,0,0,1
0,0,Quan tay nam vai day khong xu khong bai mau ong con dang Han,119000,119000,5,4,5
0,0,"  Quan dui quan short ngan unisex nam nu phong cach Han Quoc, chat lieu thoang mat – SMQST.01",99000,99000,5,1,1
0,0,Ao dui xuoc nam chui dau co tau cao cap AD806,109000,109000,1,1,1
0,0,Ao so mi ngan tay viet tien mau nhot dam lai bau regular,300000,300000,5,3,6
0,0,"Do bo the thao nam vai thun tuyet mua mem min, Thoi Trang Phong Cach Han aloha style (Freesize tu 45-70kg)-Nhieu kieu lua chon",99000,99000,4.7,22,33
0,0,Ao Khoac Hoodie Ni chong nang Danh Cho Nam Cho Nu Khong Co Mu Chat Ni Form rong in hinh Hop Sua Unisex,95000,95000,5,9,11
0,0,Bomber Basic Unisex Form Rong ,75000,75000,5,1,3
0,0,Quan kaki viet tien mau xanh den dam co 1ly Regular 1P6041,630000,630000,5,2,4
111200,44,"Do Bo The Thao Nam thuong hieu Chandi, Do Bo Mac Nha chat lieu thun cao cap mat me, tham hut mo hoi tot MS900",250200,139000,4.7,7,23
0,0,"Quan Sot Jean nam co dan 4 chieu Thuong Hieu Chandi, phong cach han quoc mau moi nhat 2021 MS107",150000,150000,4.5,2,5
0,0,Ao So Mi Nam Dai Tay In Chu Tra Sua JD944 Thoi Trang Cao Cap,135000,135000,5,5,8
0,0,"AO SO MI NAM TAY DAI , HOA TIET DEP , NHIEU MAU HOA TIET KEN BLOCK",119000,119000,5,1,3
0,0,Ao Khoac Kaki Nam Dang Vua Ao Mang To Nam Chat Kaki Sans15 Sans Shop,0,1190000,5,1,
0,0,Ao Khoac Jean Nam Phoi Tay Co Non Cao Cap,185000,185000,0,0,
0,0,Ao so mi nam tay ngan vai Oxford cao cap phu hop cong so trang ND05,199000,199000,4.5,26,77
0,0,"Ao So Mi Nam Ao So Mi,So mi Nam Tay Ngan Lua Hoa Tiet Chong Nhan, Xu Men Mai Min Mang Bao Giac May",109150,109150,1,1,1
0,0,Ao khoac du in rong co bo,74000,74000,5,1,
0,0,Quan short nam quan short kaki nam co size lon big size tre trung QS02,149000,149000,5,3,5
0,0,Ao Thun Unisex Bad Rabbit DONUT TIEDYE 100% Cotton - Local Brand Chinh Hang,350000,350000,1,1,1
0,0,"Ao Phong Nam, Ao Thun Polo Nam,  Ao Thun Nam Cao Cap, Sieu Dep M.O.N Boutique HCO002",99000,99000,3.3,3,4
87000,40,"Ao Khoac gio nam nu 2 lop chong nang - chong nuoc 2 Trong 1 kem tui poket - vai du nhe, giu am hieu qua - co nhieu mau - G01",217000,130000,3.3,12,31
0,0,  Ao khoac long cuu  Ao khoac 3 lop nam nu sieu chan gio va giu nhiet,250000,250000,4.2,5,6
22000,37,Ao giu nhiet lot ni cho ban nam,60000,38000,0,0,
0,0,Hop 4 Quan Sip Nam Thong Hoi Baeno Cao Cap,129000,129000,3,1,1
61000,20,Quan kaki nam ngan co gian nhe thoi trang TKSKJ01 PigoFashion chon size va mau,310000,249000,5,5,23
31000,16,"Ao dui nam co tau 5 khuy tre trung ArcticHunter, thoi trang thuong hieu chinh hang",200000,169000,4.3,7,17
0,0,Ao ngan tay Nam Phong Cach Nhat chat lieu dui Thai thoang mat ma A0,189000,189000,5,4,9
0,0,"ao thun nam ngan tay co co big size danh cho nguoi beo, nguoi map tu 80-140kg",420000,420000,5,1,5
0,0,"quan short nam, quan dui nam big size ngoai co danh cho nguoi map nguoi beo",349000,349000,3.7,6,8
0,0,"Ao Khoac Nam Danh Cho Nguoi Map Beo, 2 Lop Chong Tham, Mu Thao Roi - CO SIZE LON",599000,599000,4.5,4,6
0,0,"Ao Thun Polo Nam W&W Dang Regular Fit- Co Ao Khong Chan Phoi Mau Khac Biet, Chat Lieu Thoang Mat, Tham Hut Tot WPO77R",382000,382000,1,1,1
400000,25,Ao thun ngan tay co tron ADLV Baby Face Black Brown Bear Den,1599000,1199000,5,1,2
400000,25,Ao thun ngan tay co tron ADLV Baby Face Black Donut 3 Den ADLV,1599000,1199000,5,1,2
0,0,Quan Short Nam Kaki Co gian co size Dai,75000,75000,3.5,10,39
150000,38,QUAN AU NAM TRUNG TUOI CAO CAP KN41,400000,250000,5,1,3
0,0,QUAN SHORT NAM CAO CAP NHIEU MAU THOI TRANG,29000,29000,5,3,19
159200,44,Ao Thun Polo Nam Co Be Tay Ngan Chat Lieu Cotton Thoi Trang Men Luxury PL2,358200,199000,5,2,14
0,0,Ao Sweater ni ️Ao ni Ulzzang phan quang unisex nam nu tran bong Gau Sedi - AS91,160000,160000,5,2,10
0,0,Ao thun polo nam soc ngang Nexx & Dee co co be ca sau mat me trung nien JE001,149000,149000,5,1,4
127200,44,"Ao Thun Nam Ngan Tay Chandi, Chat Thun Cotton Xin Mau Moi NT22",286200,159000,5,18,40
0,0,Ao so mi nam form rong tay ngan dang suong in hinh dep,89000,89000,5,2,7
0,0,Quan Short Tap Gym Chay Bo The Thao Nam 2 Lop,150000,150000,4.6,18,133
144000,44,"Quan Sot Jean nam co dan 4 chieu Thuong Hieu Chandi, phong cach han quoc mau moi nhat 2021 MS07",324000,180000,4.5,10,34
0,0,Quan jean nam xuoc cao cap vai jean co dan hang chuan shop Phuongnamshop20 kvp13,124100,124100,2.5,2,4
0,0,Ao Thun Free Fire Mau Trang Co Tron In Hinh The Vo Cuc Mua 17 Cuc Chat HotTrend 2020 Du Size tu 29 - 99kg Danh Cho Ca Nam Va Nu,83000,83000,5,7,21
0,0,Quan Short Kaki Nam Day Lung Thun day rut that,39000,39000,4.3,6,42
0,0,Quan jean nam quan bo mau trang tron va trang rach goi ca tinh de phoi do chat jean bo co dan thoai mai van dong,127000,127000,0,0,
0,0,"Ao BOBUI 12 Angels - Ao thun Bobui Saigon , Tee BOBUI 12 Thien Than Den / Xanh / Trang / Hong",99500,99500,1,1,
0,0,Ao khoac nam chat kaki 2 lop xin xo Julido Store mau moi theo xu huong thoi trang Trend MQ04,180000,180000,3,5,31
0,0,"Ao so mi nam cong so cao cap dai tay mau trang dep chat lua form slimit thoi trang Han Quoc chat lua khong nhan mem mai mau trang den om dang dep hang VNXK, So mi nam cao cap cong so dai tay trang den",99000,99000,4.7,3,12
0,0,Ao thun tay lo form rong unisex in hinh CHAMPS ZK,57000,57000,3,1,1
0,0,Quan Jean Dai Nam MS008 - Trang,230000,230000,4.6,5,30
0,0,"Do bo nam mac nha, bo quan ao nam the thao DBNA1",155000,155000,5,1,2
0,0,"Ao thun ba lo nam Goking, ao lot nam hang hieu xuat khau Nhat Ban",139000,139000,5,60,499
0,0,Ao Khoac Gio Thu Dong Nam Trung Nien 2 Lop Co Be,339000,339000,3.8,37,142
0,0," Quan Sip Nam, Combo 3 Quan lot nam su lanh sieu mat, sieu mong mac nhu khong mac hang xuat Nhat",107000,107000,4.5,5,13
0,0,Quan Nam Kaki Basic Dang Baggy Tron Mau Phong Cach Tre Trung Thoi Trang Zenko QUAN NAM 1000060,49000,49000,3.5,2,6
0,0,Bo Quan Ao Nam Ao Thun Quan Short Nam In Chu NICE DAY Phong Cach Thoi Trang Zenkonu TOP NAM 1000147 + SHORT NAM 1000030,89000,89000,4,1,2
0,0,Ao so mi nam tay dai nua den trang,175000,175000,5,1,1
0,0,Ao da nam tay thun lot long thoi trang cao cap,315000,315000,3,1,1
0,0,"Ao khoac doi tuyen Viet Nam, hang chat luong cao",270000,270000,3,1,14
0,0,AO KHOAC NAM LOT LONG CUU SIEU AM AP CHO MUA DONG,175000,175000,3.7,3,12
0,0,Ao khoac nam nu kieu dang cardigan phoi nut hoa tiet 2 mau den-trang cuc dep thich hop di choi di hoc,77000,77000,0,0,
0,0,"SET BO THU DONG UNISEX CUC CHAT PHONG CACH THOI TRANG MOI , SIEU DEP",135000,135000,5,1,5
0,0,"Ao khoac du nam nu hai lop phoi mau EWASOME di mua ,chong nang can gio hot triend 2020",149000,149000,4.1,162,417
0,0,QUAN JOGGER JEAN NAM MAU MOI PHONG CACH 2021,278000,278000,4.8,5,12
0,0,ao so mi nam trung nien dai tay vai cotton mat dep hang chuan,99000,99000,5,1,7
270000,54,"Ao Thun Nam Polo Ngan Tay Co Be 5APCB006TTS Chinh Hang BiMan By BILUXURY ,Chat Vai PE, Spandex Cao Cap, Kieu Dang Tre Trung Lich Lam, Co Gian 4 Chieu, Chong Nhan,Thoang Mat",499000,229000,5,1,1
0,0,Quan kaki 1 li nam trung nien(3 mau) ANH THAT,249000,249000,4.5,2,4
33000,38,[AO THUN HOT TREND] AO THUN UNISEX NAM NU form rong tay lo - Free size 40-70kg -Danh cho ca Nam va Nu - LEE'S,88000,55000,4.5,23,58
0,0,"Quan jean dai nam Lb co gian, mau xam tron phom body, vai jean cotton so day dan DNBB5224",299000,299000,5,1,3
0,0,Do Lam Di Chua # Lanh Tu Nam Theu 3 Tui # Do Bo Nam # Quan Ao Nam,185000,185000,5,1,1
0,0,Do Lam Di Chua # Tim Tam # Nam Nu,152000,152000,5,1,3
0,0,Quan jean nam dai cao cap,250000,250000,5,1,
59800,10,OWEN - Ao so mi nam dai tay dang REGULAR soi Bach dan - Ma AR23393D,598000,538200,5,1,2
25000,32,Quan short nam kaki lung thun vai cotton day mat loai quan kaki coc nam form dai qua dui goi QSKLT50,79000,54000,3.4,13,36
0,0,Ao so mi ngan tay viet tien mau xanh ngoc,300000,300000,4.5,2,3
190000,43,"Ao So Mi Nam Ngan Tay 5S, Chat Lieu Bambo Mem Mai, Khang Khuan, Chong Nhan, Thiet Ke Det Hoa Tiet Tre Trung, Nang Dong, Lich Su ",439000,249000,5,23,51
0,0,Ao so mi nam viet tien dai tay mau xanh da troi,350000,350000,5,1,2
46000,40,"Ao thun nam, ao phong coc tay chat cotton, kieu dang thoi trang",115000,69000,2.3,3,47
0,0,Ao thun unisex nam nu gia re in chu crush mau moi nhat,89000,89000,4.8,8,17
160000,42,Quan Jogger Nam Nu URBAN OUTFITS Ong Suong Tron JOR04 Co Bo Thun Cotton Ni,380000,220000,4.5,2,7
0,0,"Ao khoac linh US ARMY, Ao khoac kaki nam 3313",485000,485000,3.5,4,6
0,0,"Quan Sip Nam  Thai Lan, Chat coton mem, co gian 4 chieu",65000,65000,3,1,11
0,0,Quan Short Nam Kaki Thoi Trang Cao Cap Akuba | 901,338000,338000,4.5,4,9
0,0,Ao Thun Nam Co Tim In Hoa Tiet PERVIC VM034 - 4 - Trang,119000,119000,2.5,2,4
0,0,QUAN SHORT TUI HOP LINH 6 TUI,188500,188500,1,1,1
0,0,QUAN KAKI TRUNG NIEN NAM,284700,284700,5,1,1
0,0,Ao phong nam MIKENCO TEDDY POLO BLACK LEATHER,800000,800000,5,2,2
0,0,COMBO 5 Quan dui nam mac he vai thoang mat,167700,167700,4,1,3
0,0,(Hot TREND) aO Hoodie DREW in Mat cuoi va in Chu Nam Nu Thu dong vai Ni day dan,125000,125000,0,0,
34000,43,Ao Thun Nam In Hinh Paris Everest AokNAM418 (Xam),79000,45000,4.8,8,87
0,0,AO KHOAC KAKI NAM 2 LOP DAY MIN THIET KE MANH ME CHO CAC NAM THAN HANG MOI,125000,125000,0,0,1
0,0,Quan Short Nam Kaki Lung Thun Kieu Dang The Thao Tre Trung Nam Tinh Aloha Style,125000,125000,5,18,30
16200,15,Quan lot boxer nam xam Khatoco Q5M108R0-VNMA036-2301-B,108000,91800,5,1,1
16200,15,Quan lot boxer nam xanh Khatoco Q5M108R0-VNMA035-2301-B,108000,91800,5,1,2
0,0,Quan lot nam Kendo Classic ma 03 - 09 - mau trang,45000,45000,5,1,22
0,0,Quan Tay Nam 0Ply Novelty,495000,495000,5,3,10
0,0,Ao khoac nam mu long trum dau cao cap -  ao khoac phao mu long thu cao cap co the thao roi,530000,530000,1,2,3
149000,52,Ao Thun Nam Khatoco CoolMax A3MN288R2-CNMA003-2010-N - Xam,288000,139000,4.6,17,43
0,0,"Quan dui chu V, quan short cho nam, nu cap chun phom to dep mau den, soc trang",65000,65000,0,0,1
0,0,Ao sweater den tron nam basic form rong ,69000,69000,0,0,
0,0,AO THUN THOI TRANG CO SOC CO TUI THOI TRANG LICH LAM  - ANH THAT - LZPS088,128000,128000,2,1,2
0,0,Ao Khoac Kaki Nam Gia Vest 2 Lop BD16 - Xanh Den,238000,238000,0,0,1
0,0,"AO THUN THOI TRANG NAM PHOI MAU TAY VA CO AO, LICH SU - LZPS132",128000,128000,0,0,
0,0,AO THUN NAM CA SAU CO BE CO GIAN 4 CHIEU,148000,148000,5,2,8
0,0,"Ao khoac nam suoi am bang dien - Ao suoi dien, ao khoac 3 lo tao nhiet giu am sieu nhe",485000,485000,2.3,3,20
0,0,The Playah T-shirt,599000,599000,4.8,51,113
50000,51,Quan dui the thao thoi trang nam Bonado Ha02,99000,49000,4.3,67,225
0,0,Ao khoac kaki Jean cuc chat nhieu mau sieu ngau - Hot New 2021,139200,139200,5,4,7
0,0,Ao khoac du nam nu sieu phong cach,77000,77000,5,1,3
0,0,AO KHOAC DU NAM CO NON CUC DEP,195000,195000,0,0,
0,0,AO KHOAC COTTON ,254000,254000,0,0,1
0,0,Ao thun nam co co ngan tay chu H bong lua cao cap Liyor- ATCS070,133000,133000,4.5,8,23
0,0,"Quan the thao 3 soc nam nu chat day dan, quan jogger ong suong ong bo soc den, trang",65000,65000,4.3,4,12
0,0,AO KHOAC NAM DA LON NAM CO BOMBER CUC HOT,176000,176000,5,2,2
0,0,Ao So Mi Form Rong Han Quoc Co Tron Giau Cuc Dai Tay Chat Lieu Mem Min Thoi Trang Trend Moi -SMLV19,79000,79000,4.5,80,223
0,0,"Ao khoac len nam AKUBA det hoa tiet form regular thoai mai, mat ao mem min, giu am tot, ao nhe, thoang khi 02G0076",489000,489000,4,1,1
0,0,QUAN DAI GOLF NAM,419000,419000,3.9,18,42
0,0,AO THUN COTTON MAC NHA CAO CAP NAM,169000,169000,5,1,5
0,0,"QUAN SHORT , QUAN THE THAO , QUAN LUNG MAC NHA , QUAN DUI , QUAN THUN LUNG 2 SOC ",58000,58000,5,1,1
0,0,AO KHOAC KAKI NAM CHAT KAKI 2 LOP CO NON,104000,104000,5,1,
0,0,Quan boi nam Speedo 8-127834577,755000,755000,5,1,2
0,0,Quan Sip Pump Cotton Kieu Dang The Thao Moi K222,65000,65000,5,5,17
210600,45,Quan Kaki Nam Khatoco Q2M468R1-VNMA008-1811-1 - Xam,468000,257400,4.6,46,182
138000,40,"Ao So Mi Nam Ngan Tay  Hoa Tiet (4SMCH008) Phom  Bodyfit  Tre Trung,Thanh Lich, Vai Nano Cao Cap Thoang Mat,Mem Min ,Chong Nhan Xu,Hang Chinh Hang Biman by Biluxury",349000,211000,5,2,5
156000,60,Ao thun nam tay raglan  tay ngan co tron nhieu mau GUMAC  ATNB590,260000,104000,4.5,4,28
0,0,Ao thun ngan tay co tron ADLV Logo JP Ver Black - Den,1599000,1599000,5,1,1
0,0,Combo 3 quan dui nam di bien in hinh cay dua form rong thoai mai,49000,49000,4,1,7
0,0,[ Anh That ] Ao Khoac Du Gio 7ZIA Bomber Jackets phoi mau chat du gio cao cap 2 lop thoang mat - Ao Khoac Thien HA,81000,81000,0,0,
196000,35,"Ao So Mi Nam Trang Dai Tay Chinh Hang  Biluxury (5SMDT002TRK) Nguc Ao In Hoa Dien Vi Dang Cap, Chat Vai Min Thoang Mat,Kieu Dang Sang Trong Thanh Lich",555000,359000,4,1,4
0,0,Quan sip nam tam giac cotton 100% co dan 4 chieu sieu mat sieu thoang khi loai quan lot nam tam giac thong hoi ban lon,45000,45000,5,1,7
0,0,{CO HOP} Combo gom 4 quan lot thong hoi co gian 4 chieu Nhat,54000,54000,3.5,4,18
0,0,Ao phao nam lot long cao cap co tui trong co up hinh that o cuoi,170000,170000,3,1,4
0,0,Bo 10 quan sip cheo nhat thong hoi mat lanh,129000,129000,5,1,2
0,0,Quan Short Nam Dui SHORTDEN52 (Short Den),87000,87000,2.3,3,5
135000,23,"Ao khoac nam, Ao ret da lon lot long cuu hang cao cap, mac mua dong am ap - PADOVA",600000,465000,4.7,3,4
0,0,"Quan short nam the thao cao cap, thoai mai, nang dong, tre trung – NAIKYO Thuong Hieu",199000,199000,5,4,5
0,0, combo 4 Quan sip quan lot nam tron thun lanh cao cap hang hieu (Mau tron),137000,137000,3,2,6
0,0,Quan dui ngu  nam kate cao cap mac nha,59000,59000,5,1,22
0,0,Ao so mi dui nam 6 mau de dang lua chon,110000,110000,0,0,1
200000,57,Ao So Mi Thuong Hieu Thoi Trang Nam VICERO Hoa Tiet Dai Tay,350000,150000,4.1,11,37
0,0,Ao so mi nam ngan tay mau xanh den ,98000,98000,4.8,9,24
0,0,Quan dui nam mac nha vai MAT co dan tot mac cuc ky thoai mai loai quan dui nam thong dung,16900,16900,5,1,13
300000,43,AO THUN NAM LEVI'S SS REGULAR 56605-0049,699000,399000,1,1,1
0,0,"Quan Lot Nam Khong Duong May Mong Nhe Thoang Mat Chong Han Hoa Tiet Thoi Trang, Quan Sip Tam Giac K024 - Thu rung,L",69000,69000,5,2,39
0,0,quan kaki ong rong nam tron cao cap trung nien vai nhap khau Thai Lan ben dep,199000,199000,3.6,5,16
0,0,Ao Hoodie Zip Co Tui Hop,190000,190000,5,2,3
297000,60,Ao the Thao Nam NEW BALANCE MT01612 (form Chau A),495000,198000,3.7,3,13
0,0,"Ao hoodie nam / ao hoodie nu / ao khoac hoodie form rong nam nu mac size M , L , XL  chat vai ni chong nang chong lanh tot",59000,59000,4.5,13,21
0,0,Ao so mi nam co tru chui dau mau xanh dam,149000,149000,4,4,26
0,0,Ao thun unisex form rong tay lo hoa tiet loang mau,55000,55000,5,1,1
0,0,Ao so mi nam co tru dai tay soc dep,149000,149000,4.8,4,18
0,0,"Combo 3 Quan lot nam, sip cheo nam thong hoi cao cap (Mau ngau nhien)",49000,49000,4.5,2,4
21000,13,Ao Khoac Du Nam Hai Lop Chong Nang Gio Bui Ban Cao Cap AD48 - ShopN6 (Nhieu Mau),160000,139000,4,6,10
300000,38,ÁO THUN POLO NAM LEVI'S SS REGULAR 22401-0114,799000,499000,5,1,
0,0,Ao so mi nam trung nien tay ngan vai dui SIEU MAT form rong rai thoai mai loai ao so mi nam nguoi gia hoa tiet OG52,99000,99000,5,2,7
0,0,"Ao so mi nam co tru mau trang vai 100% cotton - Ao trang khong tui,M",149000,149000,5,1,2
0,0,Ao so mi nam tay ngan co so mi,149000,149000,5,2,4
0,0,Ao thun nam tay ngan co co trung nien CAO CAP hang nhap khau bao xin loai ao thun cho nguoi lon tuoi hoa tiet trai dua,220000,220000,5,3,6
159600,40,Ao so mi Regular Fit Shirt Blamor form om chat lieu lua cao cap hang vnxk_ASM049,399000,239400,4.5,7,30
0,0,Ao so mi nam ngan tay tim than,98000,98000,4.5,2,3
0,0,Ao ba lo co vuong cotton loai 1 mem mat loai ao tap gym mat hut mo hoi tot,45000,45000,5,1,1
0,0,"Quan short kaki nam ngan Santino chat lieu cotton cao cap co dan nhe thoai mai, dang om slim tre trung nang dong SSG365A063",329000,329000,5,2,6
0,0,Combo 5 Quan lot thun lanh nam Proben,135000,135000,5,1,3
0,0,Ao So Mi Nam Cong So Hoa Tiet Thoi Trang,65000,65000,4,1,1
159000,53,Quan Short Nam Vai Kaki Cao Cap Thoi Trang Vicero,298000,139000,5,2,12
0,0,combo 4 chiec quan lot dui ( boxer) nam thong hoi co dan thoang mat,117000,117000,0,0,2
0,0,Bo Quan Ao Nam Ao Tron Co Tron Duoi Tom Quan Short Ca Tinh Thoi Trang Zenkonu TOP NAM 1000145 + SHOR TNAM 1000010,79000,79000,2.8,4,10
0,0,Ao thun nam tay ngan co tron IT'S REAL VAN TOAN,160000,160000,5,2,7
0,0,"AO THUN NAM TAY LO FROM RONG,THIET KE HOA TIET SIEU NGAU THOI TRANG MOI KME",55000,55000,3.2,5,13
0,0,(SAN HANG) Ao khoac nam han quoc sieu am,439000,439000,4.3,3,6
0,0,QUAN DUI NAM THE THAO CHAY VIEN THOI TRANG,35000,35000,3,1,6
0,0,Set 05 Quan Sip Nam xuat nhat Tam Giac Thong Hoi cao cap (40kg-95kg ),135000,135000,4,1,2
0,0,"Ao da nam dang ngan phong cach han quoc tre trung hien dai, hang co san. R8",333000,333000,5,3,5
0,0,Quan Au Nam Han Quoc Mau Mau Moi Nhat 2021,88000,88000,2.3,3,5
0,0,Quan Jean Nam Mau Moi ️️ Quan Bo Nam Ong Tum Thoi Trang Chuan Hang Shop To To Shop - QJNTT9,149000,149000,1,1,2
0,0,"Ao khoac phao nam beo sieu nhe Santino mu chum chat lieu giu nhiet, chong tham nuoc phom dang vua van 04",685000,685000,4,3,9
0,0,Ao so mi nam dai tay Han Quoc vai lua thai chong nhan cao cap loai 1 mim man thoai mai khi mac size 50-75kg,75000,75000,3.9,8,17
0,0,Quan jogger the thao nam nu unisex STYLE MARVEN dang suong phoi chu cach dieu nang dong - JOGGER NAM 9000100,79000,79000,3,1,1
156000,38,"Ao Thun Nam Polo Ngan Tay Co Be Phoi Vien Lich Lam,Tre Trung, Nang Dong Chinh Hang Biman by BiLuxury (5APCT003XDU)",415000,259000,4,2,5
150000,30,QUÀN LÓT NAM MARIO LEVI'S  37524-0154,499000,349000,5,1,1
41000,29,Ao Thun Nam Co Co Be Don Gian Cao Cap ShopN6 - AT03 (Nhieu Mau),140000,99000,4.6,5,5
61000,23,Ao Khoac Nam Big Size Ao Khoac Kaki Nam Co Non Chong Nang Chong Lanh Chong Gio Chong Tia UV Cuc Tim Han Quoc Cao Cap KK50 - ShopN6 (Nhieu Mau),260000,199000,5,5,8
197100,45,Ao so mi nam tay ngan form slim caro xanh xam Khatoco A1MN438S1-CNCR101-2009-N,438000,240900,4.5,16,33
0,0,Ao so mi nam mau trang ke soc den (MS5778358),169000,169000,0,0,
18750,25,Quan lot nam Khatoco Q4M075R0-VNMA011-2101-T,75000,56250,4.6,8,52
0,0,Ao So Mi Nam Trang Tron - XL,75000,75000,4.8,6,196
121000,48,Ao So Mi Nam KOJIBA Co Tau Mau Xam Tre Trung,250000,129000,3,7,18
0,0,Ao len nam VNXK Nhat Ban ギー AL13,286000,286000,4.8,6,17
66000,28,Ao Khoac Big Size Nam Nu Ao Khoac Kaki Unisex Chong Nong Chong Nang Chong Lanh Chong Gio 2 Lop Co Co Cao Thoi Trang Nam Tinh Han Quoc Cao Cap QK36 ,235000,169000,4.6,5,8
0,0,Blentino ao so mi cotton coc tay ke soc BCV13,425000,425000,5,1,2
36000,15,Ao Khoac Big Size Ao Khoac Kaki Nam Co Cao Hai Lop Chong Nang Chong Lanh Phoi Day Keo Nguc Gia Ves Han Quoc Cao Cap ShopN6 - QK45 ,235000,199000,2,2,5
0,0,Ao phong nam ngan tay co tron nhieu mau - khong nhan mem min tham hut mo hoi,117000,117000,5,1,2
0,0,Combo 3 quan lot nam tam giac cotton thong hoi mac mat thoai mai loai quan sip nam tam giac (giao mau ngau nhien),59000,59000,4.5,4,6
0,0,Blentino Quan tay Slim Fit SQD03(3),595000,595000,4.5,2,8
0,0,Ao thun nam trung nien vai cotton xin loai form rong rai cho nguoi lon tuoi co tui Vitin,100000,100000,4.3,3,7
0,0,Ao Thun Nam In chu Dai Tay Phoi Mau Non Trum Thoi Trang,39000,39000,4.2,21,99
0,0,Blentino ao thun nam ngan tay co co in hoa tiet PL1190,365000,365000,4,1,2
0,0,Quan Khaki Nam Dai DOCKERS 59409-0002,1199000,1199000,4,1,1
0,0,Quan Lot Nam Thong Sexy Phong Cach My,89000,89000,4.6,63,368
248000,50,"Ao Polo Nam  Biluxury (5APCT014) Chat Vai Coolmax, Spandex Cao Cap, Kieu Dang  Tre Trung Lich Lam, Co Gian 4 Chieu, Chong Nhan,Thoang Mat-Hang Cao Cap Chinh Hang Biluxury",499000,251000,4.3,3,15
11000,5,Ao Khoac Big Size Unisex Ao Khoac Du Nam Chong Nuoc Chong Nong Chong Lanh Chong Gio Chong Tia UV Co Non Tui Balo Thoi Trang Nam Tinh Han Quoc Cao Cap AD75 - ShopN6,210000,199000,4,7,16
1116000,70,Quan dai the thao unisex FILA BTS - FS2FPC1104X,1595000,479000,5,1,1
173000,51,Bo Mac Nha The  Thao Nam Mua He Thun Mong Cao Cap ZERO - BTT19 XAM - XXL,338000,165000,0,0,8
400000,50,Quan ngan nam Ellesse Bossini Fleece - 614732,800000,400000,5,1,
0,0,Ao so mi nam tay ngan hoa tiet Santino chat lieu soi tre chong tia UV dang slim ta bau sang trong ASC495S515,495000,495000,5,1,2
95000,43,"Ao so mi rong Unisex nam va nu co be tay dai, vai lua khong nhan, mem min thoang mat, tham hut mo hoi",220000,125000,5,2,2
120000,40,Ao thun nam co be co tui cao cap Pious,299000,179000,4.1,26,200
657000,60,Quan dai the thao nam New Balance - MP03905BK,1095000,438000,5,2,12
0,0,Quan Short Kaki Nam Soc CaRo Cao Cap NamMinh,119000,119000,4.5,41,80
0,0,quan bo nam ong suong cao cap co dan hang dep xuat khau,227200,227200,4.1,13,45
0,0,"Ao hoodie nam , ao hoodie nu , ao hoodie cap doi  / ao khoac nam nu ,  ao khoac cap doi form rong nam nu mac vai ni ngoai ko xu ko nhao",99000,99000,0,0,
163000,36,Quan Short Jean Nam Rach Ca Tinh AKUBA Form Skinny | 01D19069,459000,296000,5,1,3
53000,10,"Ao so mi tay dai co tru tron nam AKUBA form oversize, chat lieu 100% linen, tui truoc sang trong 02B472",529000,476000,5,2,3
0,0,Ao so mi nam hoa tiet,85000,85000,4,89,781
91000,46,"Quan Au Nam KOJIBA Chat Lieu Cao Cap, Kieu Dang Tre Trung - MDen",200000,109000,4.2,5,68
0,0,Ao hoodie mu trum HADES - CLAIRVOYANCE MEDICINE,550000,550000,5,1,6
0,0,"Ao Thun Nam, Ngan Tay, Co Tron, Lua Luoi Thong Hoi Sieu Thoang Mat, Ao Lot Nam The Thao, Ao Tap Gym, Ao Thun Nam Ngan Tay Khong Co Mac 4 Mua",65000,65000,5,1,8
0,0,Ao thun unisex nam hoa tiet ASALA phong rong UX-10,29000,29000,4.2,25,253
115000,46,AO KHOAC DU NAM HAHAMAN 2 TRONG 1 CHUYEN DOI THANH BALO CHONG THAM SIEU NHE AKD05,250000,135000,3.4,9,29
76000,15,Combo 5 quan lot nam thun brief Espresso iBasic PANM102,495000,419000,5,3,3
35000,15,Combo 3 quan lot nam cotton dui ngan iBasic PANM009,237000,202000,5,1,6
28000,23,Ao Thun Thiet Ke Nam Phong Cach Toi Gian Au My Cao Cap,123000,95000,5,1,9
0,0,"Quan Jogger Nam Nu phong cach the thao Hiphop phoi vach trang phong cach Han Quoc, vai day min Unisex aloha style",71000,71000,5,2,14
0,0,Quan Jean Nam Trung Nien Ong Suong TH012,0,250000,4.5,5,
200000,44,"Ao khoac du nam Chong nuoc, Co non Lados - 2029 chat du 2 lop form dep",450000,250000,3.8,5,9
61000,34,Ao thun nam polo ngan tay co co hoa tiet chu v ao phong nam TKAHT19 PigoFashion chon nhieu mau,180000,119000,5,2,6
0,0,Quan short jean nam mau den wash thoi trang,125000,125000,4.6,7,14
0,0,"AO KHOAC DU , AO KHOAC DU NAM CUC CHAT , CO MU CHE NANG SIEU DEP NGAU NHAT 2021 KEN BLOCK",79000,79000,3,2,3
0,0,Quan Jean Nam Ong Suong S019,0,280000,3.7,9,
0,0," Quan jean nam den tron chat bo mong nhe ong con cao cap, phu hop mua he, alex cool",0,99000,3.8,9,
0,0,Quan short jean nam cao cap,145000,145000,3,5,44
0,0,Quan dui nam mac nha dang the thao chat thun co gian 4 chieu cao cap mac di ngu - Quan short nam the thao vai thun cao gian mat me - Quan sooc nam mac di bien ngan den dau goi,39000,39000,0,0,
0,0,quan short kaki nam lung thun vai cotton day dep mac thoai mai may boi Thai Khang,79000,79000,4,22,59
127200,44,Ao Thun Nam Co Co Tay Ngan CHANDI Tron Thoi Trang 2021 MA553,286200,159000,4.8,20,37
148000,50,Quan Dui Nam The Thao Mua He Chat Lieu Thun Thoi Trang Cao cap ZERO,298000,150000,4.7,6,15
0,0,"Sip dui, quan lot nam cotton thiet ke chu U hang Quang Chau",29900,29900,0,0,2
0,0,Ao Khoac Bomber Du Bong Chay Chu So 23 Cap Doi Cuc Re Dep FTEESHIP Ao KhoacGio H909 Chong nang Kieu Bomber Jacket - AO KHOAC HIEN LINH SHOP,86000,86000,5,1,3
0,0,o Khoac Cardigan Original Chong Nang Nam Nu CapHOT RE DEPBomber Cardigan Ni Unisex So 26 Kieu Bong Chay Couple Jacket [ ANH THAT ] - HIEN LINH UY TIN SHOP AO KHOAC CARDIGAN,93000,93000,0,0,
102090,41,Ao phong nam tay lo from rong mau trang in decal VINHCUUT,249000,146910,5,5,10
0,0,AO KHOAC BOMBER NAM NU THEU RONG,78000,78000,0,0,1
102090,41,Ao thun Tay lo Nam Nu Unisex Form Rong In Phan Quang Huou mau den vai cotton phoi voi quan jogger thich hop cho unisex,249000,146910,4.5,5,24
59040,41,Ao thun nam nu Unisex Chu Vien co NOCROSS nhieu mau doc la Ao thun nam tay lo mau den trang Trum Unisex,144000,84960,5,1,3
47000,20,Quan boi nam cao cap Narsis Q1001 den ke soc,235000,188000,1,1,2
186000,42,Quan tay nam Novelty 0Ply 1709220 mau xam dam,445000,259000,5,4,20
0,0,Quan Jean Nam Rach Goi Mau Den Tron,143000,143000,3.3,6,20
0,0,quan sit nam tam giac  Freeship tu 150k  Combo 5 quan nhat thong hoi nam- sip tam giac cap to,24000,24000,4,1,5
0,0,Bo 4 chieu quan ship dui nam thong hoi - giao mau ngau nhien,69900,69900,0,0,
0,0,"COMBO quan lot nam chat lieu cotton,quan xi nam tam giac lung lon vai cotton chinh pham 100% sieu thoang mat ms09",97500,97500,5,1,
25000,20,Ao thun ba lo nam Narsis D8054A mau ke xanh vien xanh da troi,125000,100000,4.8,9,26
65000,20,Quan Jogger Nam Narsis G8022 - Xanh,325000,260000,4,4,9
99000,20,Bo Quan Ao Nam Thu Dong - E7023,495000,396000,4.3,3,8
63960,41,ao thun tay lo nam nu Stee Body Phan quang mau den  thun cotton Ngau Store,156000,92040,4,1,1
63960,41,Ao thun Tay lo Nam Nu Form Rong Vit Con Trum Unisex mau den vai cotton thich hop di choi di da ngoai,156000,92040,4.5,2,2
0,0,"Combo 4 chiec quan sip dui nam (boxer) cap nho thong hoi thoang mat nam tinh, sang trong SEM-08 hop 4 chiec 4 mau lam qua tang sang chanh ( tu side L, XL, XXL, chon side theo phan loai)",70000,70000,0,0,
112050,45,Ao Phan Quang Nam Form rong chat vai cotton Ngau Store doi canh SWING,249000,136950,5,1,2
102090,41,Ao Thun Nam Tay Lo Unisex co Tron chat lieu vai cotton mau trang form rong in chu Enternity phong cach doc chat NS075,249000,146910,4.7,25,57
97110,39,Ao thun Tay lo Nam Nu Form Rong WHITE bang lon mau den vai cotton,249000,151890,5,2,5
117000,39,Ao thun nam nu Unisex Thien Than Paris doc la Ao thun nam tay lo mau den trang xanh Trum Unisex aothununisex,300000,183000,5,1,1
0,0,quan short nam kaki lung thun vai cotton day mat hang chuan may boi Thai Khang,79000,79000,3.5,18,54
0,0,So Mi Nam Dai Tay Co Ve In Hinh Meo Hoa Tiet Chu UNNY Thoi Trang Zenkonu SO MI NAM 1000026V3,89000,89000,1,1,1
65250,15,Ao thun LEVENTS Internetlove Pixel/ White,435000,369750,5,2,2
441000,30,MLB - Ao thun tay ngan nang dong Cash Cow 31TSC9131-50W,1490000,1049000,5,1,1
235000,47,"Ao so mi nam dai tay, chat cotton cao cap, min mat thoi trang han quoc",500000,265000,4.7,3,8
150000,50,Ao Ni Nam Tron 8 Mau Phong Cach Nang Dong VICERO,300000,150000,5,8,16
17000,14,Quan Lot Nam Jockey Tam Giac Thun Visco Thoang Mat - J1145,125000,108000,5,1,14
28700,17,QUAN DAI KAKI TRUNG NIEN BEN MAU,167700,139000,5,1,1
0,0,"Ao khoac Blazer nam tron sang trong AKUBA form regular, mac thoai mai, nhieu mau 02150",1569000,1569000,4,1,2
0,0,Ao Ni Nam Chat Ni Len Da Ca Day Dan Kieu Dang Sang Trong Nam Tinh,100000,100000,3,4,14
50000,38,quan baggy dui nam dang dai ong con chat dui nhieu mau,130000,80000,5,10,13
0,0,Quan jean nam rach vay son cao cap vai jean co dan hang chuan shop Phuongnamshop20 j9,155400,155400,1,1,3
0,0,Quan tay au nam dang om ong con vai chong nhan cao cap khong bai khong xu,89000,89000,4.5,2,3
0,0,"Ao polo nam , co det bo len , hinh in sac net ,ao thun nam co co tay ngan thanh lich POLO-15 - Soha Clothing",210000,210000,5,1,4
0,0,Ao Khoac Nam Vai Kaki 2 Lop Mac Bon Mua Kieu Dang Thoi Trang,499000,499000,4.2,15,40
0,0,Ao khoac phao nam co mu thao roi duoc,199000,199000,4.3,56,89
0,0,AO KHOAC DU NAM BOMBER UNISEX MAU SAC SINH DONG,97000,97000,2,1,10
0,0,"Ao Gio Lot Cotton Vai Van Gao Cao cap Pmax Nam Nu 2 Lop, Mu Thao Roi, Chong Nuoc, Chong Gio, Chong Nang, Phom Tre Trung",259000,259000,5,9,10
0,0,Ao So Mi Trang Theu Trai Tim Do,100000,100000,2,1,1
0,0,Hop 4 quan sip dui thong hoi cho nam,98000,98000,5,1,1
174000,60,Ao thun polo nam theu GUMAC ATNB5102,290000,116000,4.8,16,37
188000,56,Ao Thun Nam Co Co Tay Ngan Polo Tron Thoi Trang VICERO 6 Mau,338000,150000,4.2,90,217
149000,63,Quan Dui Nam The Thao Thun Ni Thoi Trang 5 Mau ZERO,238000,89000,4.5,48,127
0,0,"Ao giu nhiet nam tron co tron Santino om, thoai mai, phu hop moi do tuoi TSD245P876",245000,245000,4.8,4,17
0,0,Baggy óng rọng Nam - Quan Jean Nam Phong cach han quoc- quàn bò nam ( óng rọng xám cg 1 ben),193000,193000,3,2,2
0,0,Quan Short Nam Size Dai (size 34-37),59000,59000,3.8,13,37
0,0,Ao Trang Phat Tu Vai Dai Loan Cao Cap# Nam Nu,230000,230000,5,1,4
32670,11,COMBO 3 QUAN LOT NAM RELAX DANG BOXER CHAT LIEU COTTON CO GIAN 4 CHIEU,297000,264330,5,13,34
56800,10,OWEN - Ao so mi coc tay soi NANO AR22894N,568000,511200,5,1,1
0,0,Quan Jean Nam Mau Den Tron,99000,99000,3.7,3,9
76000,51,Ao so mi nam dai tay form rong trung nien vai kate do Thai Khang dat rieng loai OGD9,149000,73000,3,6,21
0,0,Quan jean Baggy nam chat bo ong rong den TILAA FASHION QJ02,175000,175000,5,1,7
0,0,"Quan au nam dang slimfit, chuan thiet ke han quoc, cuc ton dang, lich su, tre trung",99000,99000,4.8,4,11
0,0,Combo 3 Quan Sip Cheo Nam cotton cao cap Nhat,59000,59000,0,0,2
0,0,"Quan baggy, jean nam, xanh sang TR03, ong suong, rong style han quoc 2021",0,179100,2.5,2,
0,0,"Quan bo, Jean Baggy nam TR01 ong Suong, rong style han quoc 2021",0,165000,5,1,
0,0,Ao thun nam nu form rong - Ao thun nam big size - Ao thun danh cho nguoi map nam,68000,68000,4,1,2
0,0,Ao phong nam nu trang - Ao phong nam big size - Mau Ao phong cho nguoi beo,68000,68000,3.3,3,7
0,0,Ao thun size lon cho nguoi beo,75000,75000,5,1,1
0,0, Ao phong big size cho nguoi map,75000,75000,5,2,6
0,0, Ao thun nam nu tay ngan - Ao rong big size - Ao phong cho nguoi beo nam,68000,68000,5,1,
0,0,Ao nang NAM co KHOA KEO CAO CHE MAT cao cap ,70000,70000,5,1,1
0,0,Ao Thun Nam [DAI TAY CO LOT NI],39000,39000,5,2,7
0,0,Ao giu nhiet nam lot ni co 3 phan,39000,39000,2,2,3
30000,11,Combo 3 Quan Lot Boxer Vai Soi Modal (Go Soi) thuong hieu Coolmate,279000,249000,4.3,7,122
0,0,Quan Au nam Tim Xanh Vai Cheo Loai Dep Quan Tay Nam co dan khong nhan dang han quoc,85000,85000,0,0,
0,0,"Quan Au Vai Tuyet Mua Quan Au Nam Ong Con Mang Lai Phong Cach Tre Trung, Lich Lam - Mac La Dep - Ma QTM",120000,120000,0,0,
0,0,"Quan Jean Nam Vovesa Nhieu Mau Moi, Dang Om Tre Trung, Nam Tinh",99000,99000,5,3,4
0,0,Ao khoac jean nam JKNA-019,149000,149000,3.5,2,7
0,0,"Combo 5 Quan sip tam giac thong hoi, xuat Nhat giao mau ngau nhien",80000,80000,0,0,
0,0,Ao thun One Piece Luffy ,69000,69000,2,1,
0,0,Ao Free Fire Rank Huyen Thoai - Ao Hoodie Shop Aoin3D,185000,185000,3,1,2
51000,15,Combo 5 cai ao sat nach ba lo tanktop TKCB5ASN01 PigoFashion giao mau ngau nhien,330000,279000,5,3,14
0,0, Ao khoac da cho nam cao cap J10,275000,275000,4.7,3,8
0,0,AO KHOAC KAKI NAM UNISEX -LLQAK01,98000,98000,4.5,27,103
0,0,Ao Khoac Nam Du Can LG01,120000,120000,3,3,7
0,0,Ao Khoac Da Nam Thai AKD125 - Den,305000,305000,3.7,21,49
0,0,Quan jean dai nam tron thoi trang - B2000,104000,104000,4.7,13,25
0,0,Ao so mi nam co be Quoc Dan dai tay vien tay ao  Hot Trend trang ,98000,98000,5,2,2
0,0,Quan jean nam cao cap vai xin,109000,109000,2.5,44,191
0,0, Ao so mi nam tron khong nhan LAVIC-523 Form chuan,92000,92000,3.5,13,49
310000,67,Ao So Mi Dai Tay Nam Hoa Tiet Lich Lam Thoi Thuong,460000,150000,4.1,11,45
0,0,Ao khoac jean nam phong cach Han Quoc AKJN012 (Xanh bo),129000,129000,4.5,19,48
0,0, Ao Thun Roronoa Zoro ,102700,102700,1,1,1
0,0,"Ao so mi nam dai tay Ke SMT010, So mi nam ke loai dep",110000,110000,4.8,12,26
0,0,Ao khoac gio chong nuoc Ao du the thao nam G-01,124000,124000,2.3,4,10
0,0,AO SO MI CAP DOI NAM NU I LOVE YOU HOT TREND HAN QUOC,70000,70000,5,10,27
0,0,AO VEST NAM CAO CAP V2558112,195000,195000,3.8,4,10
0,0,Ao thun the thao nam ADIDAS PRIMEBLUE TEE - GD8675,1100000,1100000,4.5,2,2
0,0,Ao So Mi Nam Hoa Tiet Ngoi Sao,110000,110000,5,1,
0,0,Ao So Mi Nam Rong Hoa Tiet ,99000,99000,4.5,7,12
0,0,"Ao Khoac Nam, Ao Khoac Du Nam Cao Cap Mau Moi, Ao Khoac Du Nam",160000,160000,0,0,2
0,0,Ao Vest Nam Cao Cap Ao Vest Cong So Hai Lop,220000,220000,3.5,4,8
61000,47,Quan lot dui Boxer nam thun lanh cao cap thoang mat Pigofashion QLPG03 ( mau ngau nhien),130000,69000,4,1,25
28500,15,QUAN BOI TAM GIAC CAO CAP QT252,190000,161500,5,4,6
0,0,COMBO 03 ao lot nam kieu ba lo trang hang Viet Nam ,72000,72000,0,0,
0,0,Compo 4 quan nam chat thun lanh co gian 4 chieu,78000,78000,5,1,3
0,0,Combo 5 Quan Sip Nam Xuat Nhat Thong Hoi Co Gian 4 Chieu Thoang Mat Chat Sin,75000,75000,4.8,4,9
59000,50,Ao thun nam nu unisex tay lo phong form rong teen co tron oversize cotton gia re basic den trang tee pull Chu Nhat Thoi Tiet,118000,59000,5,1,8
59000,50,Ao thun nam nu unisex tay lo phong form rong teen co tron oversize cotton gia re basic den trang tee pull UGKLF ,118000,59000,5,1,1
59000,50,Ao thun oversize form rong tay lo oversize phong nam unisex co tron streetwear gia re han quoc BAR,118000,59000,1,1,3
59000,50,Ao cotton nam nu unisex phong tay lo ulzzang thun den cotton oversize form rong in hinh cool ngau VISA,118000,59000,4.5,2,10
99000,50,Ao hoodie ni ngoai ulzzang nam nu unisex cap doi sweater local brand khoac zip choang cardigan chong nang SOMETHING,198000,99000,1,1,
0,0, QUAN BOI ADDICTED HOT BOY CAO CAP QT194,200000,200000,5,2,3
0,0,Ao Hoodie Ni Ngoai Tron Du Mau ( unisex nam nu deu mac duoc),68000,68000,4.5,6,11
0,0,Ao ni Hoodie ni ngoai unisex tron du mau (unisex nam nu deu mac duoc),57000,57000,3.8,4,17
49000,38,Ao Dui Nam Coc Tay Co Tru,129000,80000,4.5,41,121
0,0,QUAN AU NAM NAM ONG CON HAN QUOC 2018 (DEN),97000,97000,3.3,3,10
0,0,Ao ni hoodie ESSENTIALS nam nu fom rong unisex oversize chat ni ngoai may 2 lop ti mi hinh in deo Han Quoc AT 9811,123000,123000,0,0,
0,0,"Ao Khoac BomBer Nam Nu Theu Sticker Truoc Sau , Phoi Mau Cuc Teen, Mac 4 Mua, Vai Mem Min Chong Nang Cuc Tot, Form Duoi 75kg Thich Hop Cac Ban Tre Tuoi Teen Nam Va Nu",100000,100000,5,2,10
0,0,Quan tay nam quan nam,88000,88000,3.5,17,126
0,0,Quan Tay Au Mau Tron Cho Nam ,99000,99000,4.3,8,35
0,0,Ao ni Hoodie nam form rong tron nhieu mau sac chat ni day dan chat luong cao cap,85000,85000,5,1,3
28050,11,COMBO 3 QUAN LOT NAM RELAX RLTK018 DANG BRIEF CHAT LIEU COTTON CO GIAN CAO CAP ,255000,226950,4.7,26,101
0,0,Ao So Mi Nam Dai Tay Trang Co Tui Phong Cach Han Quoc Chat Vai Dui Xuoc Chong Nhan Form Body 18,135000,135000,4.5,2,3
59000,50,Ao thun nam nu unisex tay ngan phong body teen co tron oversize cotton gia re basic den trang tee ulzzang MOIM FINE,118000,59000,5,4,8
59000,50,Ao thun form rong unisex nam nu tay lo phong streetwear cotton oversize gia re in style ulzzang SWAG,118000,59000,5,2,3
109000,50,Ao hoodie nam nu unisex cap doi local brand ni ngoai form rong co mu ulzzang han quoc LUFFY cute zip chong nang,218000,109000,3,2,2
0,0,Ao Vest Nam Thoi Trang Phoi Vien Tui Nhieu Mau AVNM01,195000,195000,3.9,28,77
0,0,Ao polo nam trung nien co tui ️ Hang VNXK ️Ao thun nam trung nien co tui ( chat lieu cotton 100%),159000,159000,5,1,9
0,0,Quan Jogger Kaki Nam Dang Tre Trung JOGGER03,85000,85000,3.6,5,15
110000,33,Quan Short Nam Di Bien Cao Cap QSN710,329000,219000,4.6,5,62
0,0,Quan Short Nam Cao Cap,299000,299000,4.3,29,423
0,0,Ao ni co khoa be chat lieu ni da ca chan cua giu am tot - thiet ke thoi trang - logo ep nhiet thoi trang phai manh,199000,199000,5,1,
0,0,"Quan the thao nam -quan Jogger nam chat Umi mac nhe, thoai mai",79000,79000,0,0,
0,0,"VARDINO ao khoac nam cao cap co be - co dung, tron - hoa tiet, mem - min - nhe - khong nhan - khong phai - chong nuoc chinh hang dang xuong - om vua - vat bang cong so trung nien moi ak07",895000,895000,4.3,10,32
56800,10,OWEN - Ao so mi coc tay soi Bach Dan BA22696NT,568000,511200,5,1,1
0,0," AO KHOAC THE THAO, AO KHOAC SIEU AM, CHAN GIO GIU NHIET 2020",499000,499000,4.5,2,2
0,0,Ao so mi nam ke caro tay dai,99000,99000,3.7,28,266
0,0,"Ao khoac du kieu bomber Seven Zia phong cach ca tinh nang dong form dep,Ao khoac du bomber nam phong cach Han Quoc cuc dep , sieu ca tinh",110000,110000,5,1,1
34000,30, Ao thun unisex tay lo form rong - Phong luffy moi,113000,79000,5,1,1
56000,10,OWEN - Ao so mi coc tay soi Tre mem min thoang mat AR22544NT,560000,504000,5,1,1
78000,16,Combo 3 quan lot nam khong duong may Brief Seamless iBasic PANM094,477000,399000,5,1,3
209000,50,Bo Quan Ao Nam Nang Dong Tre Trung Cao Cap ZERO,418000,209000,1.5,2,20
0,0,"Ao Thun Tron Basic Nam Nu Deu Mac Duoc - Phong Cach Tre Trung, Nhieu Mau, Nhieu Size Phu Hop Voi Moi Nguoi - ATT01",45000,45000,5,6,18
0,0,Ao So Mi Nam Trang Tron - M,66000,66000,0,0,1
0,0,Quan Jogger Kaki Nam Chat Mat - Ran Ri tre trung T06,78000,78000,3.6,14,40
0,0,AO KHOAC HOODIE. AO KHOAT HOOIDE STICK NAM NU,105000,105000,5,1,3
59000,10,OWEN - Ao so mi dai tay soi Tre dang Regularfit AR22553DT,590000,531000,5,1,1
159000,50,Ao polo nam ADINO mau xanh bich vai cotton co gian thiet ke basic tre trung PL50,318000,159000,5,1,
0,0,QUAN DUI NAM SLIM ONG SUONG,360000,360000,1,1,1
0,0,Ao Free Fire -Kelly FF,137700,137700,5,1,1
97000,20,Ao Gile Aligro ALENGL009 Co Tim Tim,485000,388000,4,2,3
0,0,"Ao thun tay lo form rong STREETWEAR phong unisex nam nu, ao thun cotton100% phong cach streetstyle HINH IN KO TROC",189000,189000,5,1,1
0,0,Ao khoac da nam cao cap chat lieu ben bi sang bong phong cach nam tinh dang cap Ohazo! - XA02,450000,450000,4,1,2
0,0,Quan lot nam trong suot goi cam,39000,39000,4.5,2,8
0,0,ao khoac du cao cap chong nang,215000,215000,5,1,1
0,0,Ao Phong thun Hero Team miniworld,119000,119000,4,1,1
0,0,Ao thun nam in logo Binance Crypto mau den va trang M2879,115000,115000,5,1,18
0,0,"Combo Quan Au Nam Ikemen Mau Den, Ao So Mi Nam Trang Dai Tay Dang Om Body",416000,416000,4,1,1
0,0,"Quan JEAN Nam den rach goi, dang om ong con",252000,252000,5,1,
0,0,"Quan jean nam rach goi ca tinh, Quan bo nam rach goi co gian from chuan dep gia sieu re",129200,129200,5,1,
0,0,Ao len nam vai mem min khong xu co 3 phan body han quoc,155000,155000,4,5,11
0,0,Ao thun NEEDS OF WISDOM Climbing Tee. - Unisex,345000,345000,5,1,1
0,0,"Bo Nam Ngan Tay Vai Dui Cao Cap Mem Nhe Thoang Mat Ben Dep Phu Hop KHi Dao Pho, Choi The Thao",145000,145000,5,1,7
0,0,Quan dai kaki tui hop cao cap Hai Trieu 023,230000,230000,1,1,4
45000,35,QUAN DUI  NAM KATE FEZZIO 100% COTTON CO TUI SUON,129000,84000,5,2,4
130000,10,"OWEN - Ao khoac nam OWEN, ao gio Jacket cao cap giu am tot JK61025 ",1300000,1170000,3,1,1
0,0,Ao thun giu nhiet dai tay body Ariza,59000,59000,4.5,2,7
0,0,Ao Thun Nam Ao Thun Nam Polo Phoi Ba Mau Mau KL01 Thoi Trang Nam Cao Cap,125000,125000,2.7,3,4
0,0,Ao somi nam KAKI form xuat khau,145000,145000,5,2,
0,0,Ao khoac du nam 2 lop co non thoi trang SITAKI cao cap AKD23,165000,165000,4.8,6,17
0,0,"Bo Do Ni Da Ca Nam (Chat Dep, Phong Cach, Thoi Trang Dao Pho)",295000,295000,4,1,3
0,0,"Sip Dui- Quan Lot Nam Boxer Cotton Mem Nhe Thoang Khi Hoa Tiet Chu New K023 - Tim,L",55000,55000,5,1,1
0,0,Ao Khoac Len Cao Cap Co Lot Am Ben Trong 48 -85kg,349500,349500,3,1,
0,0,Quan Dai Trung Nien Cong So Cho Nam Ma DTN1,219000,219000,5,1,6
0,0,(SALE) Ao Thun Tay Lo Unisex Viet Nam,166000,166000,4,1,1
0,0,Quan Jean Nam Streetwear Cao Cap FNOS NZ13 Mau Xanh Sang - Rach Goi Form Slimfit - Jean Thun Co Gian.,550000,550000,5,1,2
0,0,"Quan Short Jean Nam Ngan , Quan Bo Lung Nam Co Gian Sieu Chat OBOK Fashion QSN94",149000,149000,5,2,4
61200,19,Ao khoac du nam 2 lop 2 mat chong nuoc cao cap AKD111,319200,258000,5,1,2
0,0,Quan sip tam giac - 0609,95000,95000,4,2,2
50000,30,Quan short nam Hahaman jean cao cap QJ011,169000,119000,4.2,11,16
0,0,Ao YUKATA Nhat Ban form Unisex,149000,149000,5,1,1
0,0,Quan Short Nam Kaki Co Dan Tham Hut Tot :: Quan Ngo Nam Chat Kaki Loai 2,109000,109000,1,1,5
0,0,Quan sot lung kaki Nam day rut lung bang thun,69000,69000,4.6,7,22
0,0,# do bo di chua#do nam phat tu nam theu,180000,180000,5,1,1
65000,46,"Quan JOGGER 3 soc bo chan chat thun ni mem min thiet ke NANG DONG, TRE TRUNG",140000,75000,5,1,4
0,0,Ao thun gia dinh ,45000,45000,5,4,4
0,0,Ao khoac kaki nam cao cap vai day chong nang tot hang chuan shop Phuongnamshop20 j24,108750,108750,5,1,
0,0,Ao so mi ngan tay nam Owen Bamboo Bodyfit hoa tiet caro - BA22683NT,548000,548000,5,1,1
0,0,Quan lot nam Caliven Keni 280,19000,19000,5,1,7
0,0,AO KHOAT NAM CAO CAP PHOI 2 TUI THOI TRANG SIEU HOT,89000,89000,5,2,
50000,23,"Ao so mi nam body cong so ke soc, chat vai tho mem mai tham hut mo hoi, thoi trang tre, phong cach Han Quoc",219000,169000,5,1,1
0,0,QUAN LOT NAM 8002,47500,47500,5,2,3
0,0,Ao Thun co tron mau xam - 8051,125000,125000,5,1,1
0,0,Ao khoac jean nam rach cao cap vai jean denim khong nong hang chuan shop Phuongnamshop20 rkv15,160000,160000,4,1,
0,0,"Kem Tan Mo Bung Nam Gioi, tan mo toan than 100 % tu thien nhien Tang quan sinh nhiet",250000,250000,5,1,
0,0,Ao ni hoodie nam day dan cao cap nhieu mau sac phong cach Hotfrend Han Quoc chat luong gia re,129000,129000,1,1,2
0,0,BO DO NAM MAC NHA VAI NI COTTON,239000,239000,5,1,5
0,0,AO THUN NAM NGAN TAY CO TRU PHONG CACH HAN QUOC ATN01-DEN,193700,193700,4,1,1
0,0,"Quan au nam, quan baggy den co dan om ong con vai chong nhan cao cap khong bai, xu",85000,85000,4,3,6
0,0,Ao Thun Nam Theu Hoa Tiet Ho Cuc Ngau,125000,125000,5,1,1
0,0,"Quan Short Jean Nam VNXK Co Gian, Khong Phai, Khong Bai",250000,250000,1,1,3
0,0,Ao thun tay lo Wind phong unisex form rong Dao Si nam nu oversize cotton ulzzang,70000,70000,5,1,4
0,0,Ao khoac du nam nu mac duoc 2 mat thoi trang cao cap ,130000,130000,2,4,11
0,0,Ao thun Hero Team Mini World sieu cute | Hang doc vai dep | 4 mau MC14,0,118800,5,1,
0,0,"Ao thun nam co be vai ca sau, Combo 2 ao – EZ233",269000,269000,4.5,5,14
0,0,Quan ngu kate nam,55000,55000,3,1,3
0,0,Quan short lung tui hop hang xuat ban tai xuong may,35000,35000,3,2,11
0,0,Quan jeans nam ong slim thoi trang Messi SJM-769,480000,480000,5,1,1
0,0,Ao khoac kaki bomber 2020 AKK19,357500,357500,4,1,1
0,0,sip nam xuat Nhat - kieu dang thoi trang - lich lam ,22000,22000,5,1,5
0,0,So Mi 4 Vach Mau,540000,540000,5,1,1
0,0,Ao so mi nam hoa tiet  MR MY STORE vai Lua Thoang mat - Khong nhan - Form suong Dog bug,390000,390000,5,1,2
154000,44,COMBO 2 QUAN SHORT NAM FEZZIO CHINH HANG ,350000,196000,5,2,7
0,0,Ao thun nam nu unisex tay lo form rong in nhiet cao cap chat luong,84387,84387,4,1,1
0,0,Ao so mi nam ngan tay form rong hoa tiet MNY loang mau chat vai voan chiffon mem mat min,99000,99000,1,1,5
0,0,Ao thun Nam mau xam America dep doc dao - BIGSIZE 3XL 4XL 5XL 6XL 7XL M1076,144000,144000,4,1,
0,0,Ao len nam cao cap co lo dai tay van vat cheo phong cach han quoc AL04 Micado,199000,199000,5,1,4
0,0,{FREE SHIP } AO SO MI NAM TAY DAI VAI DUI NHAT PHONG CACH THOI THUONG LICH LAM,115000,115000,3,1,1
51000,34,"Quan jogger thun nam 1 soc lon ArcticHunter, thoi trang phong cach tre",150000,99000,5,13,28
0,0,"AO KHOAC DU NAM NU THIET KE MEM MIN,CHAT LIEU VAI DU THOANG MAT",99000,99000,5,1,2
0,0,Ao so mi nam tay dai form rong hoa tiet vai lua S3,252000,252000,5,1,2
0,0,AO KHOAC DU NAM NU 2 LOP MAU MOI,190000,190000,3,2,3
0,0,Ao so mi nam form rong ngan tay hoa tiet in hinh thu noi bat phong cach ca tinh chat vai voan lua mem mat min,99000,99000,5,2,3
0,0,Ao thun tay dai Titishop ATN182,246000,246000,5,1,
0,0,Ao thun 7 vien ngoc rong chibi Trang Nam Nu,67150,67150,5,1,
0,0,Ao hoodie den trang tron nam nu form rong han quoc unisex dai tay basic Ao hoodie ni bong den trang YiiL HD07,155000,155000,1,1,1
0,0,"Quàn jean nam, quan bo nam kiẻu moi phong cách Tre trung hot trend 2021 ms23",137000,137000,5,1,4
0,0,Set  Bo Quan Ao Thun Nam Thoi Trang  Phong  Cach Han - HATI - (Kem anh That) - TN5181,118000,118000,4.5,53,168
0,0,Ao Thun Unisex Bad Rabbit LAZY - Local Brand Chinh Hang,420000,420000,5,1,4
0,0,"Ao thun nam form rong, ao phong tay lo Unisex ATL216 - Yinxx",69000,69000,5,2,4
101000,40,Ao so mi nam kate ford HAHAMAN cao cap SMF1002,250000,149000,5,1,1
0,0,Ao khoac kaki nam cao cap vai day chong nang tot hang chuan shop Phuongnamshop20 kv164,117300,117300,4,2,2
50000,36,"Quan jogger thun nam 3 soc trang 06, hang nhap Quang Chau",138000,88000,5,1,1
40000,20,AO T-SHIRT NAM FEZZIO HOA TIET ,199000,159000,5,2,4
0,0,Ao SO mi nam co tru Soc kieu Han Quoc,142800,142800,4,1,2
0,0,COMBO 4 QUAN SIP DUI NAM CAO CAP THUN COTTON BODY,116000,116000,3,1,1
0,0,Ao thun RESIDENT EVIL - ao game cuc chat,108000,108000,4,1,1
0,0,(ANH THAT) Ao thun THE LAST OF US 2 | Ao THE LAST OF US TSHIRT,0,144000,4,1,
0,0,Ao Thun Nam Dai Tay Phoi Mau co Gian Tot,149000,149000,2.5,2,2
0,0,Ao ni Hoodie Drew House VẸT  Ao hoodie nam nu ni bong cotton,179000,179000,1,1,2
0,0,COMBO 3 Ao thun khong co tron nam Santino chat lieu Cotton co gian 4 chieu thoai mai,299000,299000,5,1,2
0,0,BO QUAN AO THE THAO BA LO NAM THOANG MAT,239000,239000,4.5,2,2
0,0,bo the thao nam bo nam chat dep SPORT,99000,99000,2,1,2
111000,50,Ao Thun Tay Lo co tron Unisex COSTA RICA mau DEN/TRANG /Nam nu unisex ️ Jay storee Kieu ao phong form rong,220000,109000,3,1,1
0,0,AO SO MI NAM ADAM STORE NAM KE SMC018,650000,650000,5,1,1
0,0,Ao len nam co tron han quoc phoi chu so 2021,180000,180000,4,1,2
0,0,Quan tay au nam vai cao cap phu hop cong so ND01,219000,219000,4.7,25,46
0,0,QUAN AU NAM ADAM STORE DEN QDM,600000,600000,5,1,1
0,0,Ao thun polo nam ca sau co co be Nexx & Dee soc ngang trung nien vai cao cap ND06,149000,149000,5,1,
89000,50,Ao khoac nam nu ni ngoai hoodie tay phong tron,178000,89000,0,0,1
0,0,"Ao thun Nam xuat khau 100% Cotton 4 chieu, co gian, co BigSize 100kg form Unisex. Ivan BigSize AT109",200000,200000,4,1,
0,0,Ao khoac du nam cao cap vai du xin chong tham nuoc tot hang chuan shop Phuongnamshop20 kvo46,81000,81000,4,1,3
0,0,AO THUN NAM CO TRON,65000,65000,5,1,3
0,0,Ao Phong Doi Dep MS01 (Gia 1 Ao),20000,20000,5,1,1
0,0,Ao Thun Nam Ao Thun Nam Polo Vien Vai Full Mau VG01 Chat Thun Mat Tre Trung,125000,125000,3,2,2
0,0,Mau ao Hoodie AMong Us cuc ngau,219960,219960,5,1,
0,0,"( VDEO- ANH THAT 100%) BO DUI NAM Quan Dai Ao Dai, So Mi Quan Dui Dai Tay atbshop",229000,229000,3,1,4
0,0,Ao so mi nam coc tay May 10 010120026 AH177,338000,338000,4,2,5
0,0,Ao so mi nam dai tay May 10 ma 010119441 AH224,348000,348000,5,3,4
0,0,Ao len nam co lo chat len cotton,115000,115000,5,1,
201000,57,Combo 2 Quan shorts the thao nam dang sot sport dui chat thun lanh 4 chieu cao cap phu hop tap gym hay mac nha mau trang va den DUI-P101 (tang 1 non),350000,149000,4,22,121
41000,12,"Combo 3 chiec quan lot thong hoi nam Aristino ABF060, mem min, thoang khi, tre trung - Hang Chinh Hang",330000,289000,5,5,10
0,0,"Ao polo nam , co det bo len ,ao thun nam co co tay ngan thanh lich - Soha Clothing PLD1",149000,149000,5,2,2
0,0,AO KHOAC DU NAM NU PHOI MAU CHUAN PHONG CACH HAN MOI NHAT 2020,97000,97000,1,1,1
0,0,"Ao khoac gio cao cap 2 lop, chong nuoc chong gio chong nang cao cap",169000,169000,5,1,3
0,0,Do bo the thao nam he in hoa tiet sieu hot ASALA (BTN-102 ( PET-12),89000,89000,3.9,19,54
0,0,AO THUN SWE CAM UNISEX  Chat cotton sieu dep - Ao phong SWE Dom Cam Chat,290000,290000,5,1,4
0,0,Ao Thun Unisex Bad Rabbit TRIPPY LAND 100% Cotton - Local Brand Chinh Hang,340000,340000,5,1,1
0,0,Ao the thao bong da CLB Man City Galaxy - Do da banh 2020,129000,129000,5,4,6
0,0," Quan lot nam cotton cuc xin mac em va mat, xip RM 1x501",25000,25000,5,2,4
0,0,Quan dai the thao jogger nam 3 soc cao cap thoi trang phong cach Q17,99000,99000,5,2,3
0,0,"AO KHOAC KAKI NAM , AO KHOAC NAM CAO CAP THIET KE CO MU CUC CHAT GH186",128790,128790,4,1,
0,0,"SET BO THU DONG UNISEX CUC CHAT ,SIEU DEP CHO CAC BAN TRE VINA FASHION",135000,135000,2,1,
0,0,Ao thun ba lo nam CA01M ,50000,50000,1,1,2
14000,20,Quan short the thao nam GABOFASHION tui khoa cao cap QSTT2173,69000,55000,5,1,9
0,0,"Ao Polo Nam, Ao Thun Nam Tay Lo Co Co, Chat Lieu da ca sau, Phong Cach The Thao, Full Mau, Full Size - AZILA - AC110",139000,139000,4,3,3
0,0,"Ao thun nam co tron  vai Cotton co gian,day dan, form regular fit B02",139000,139000,5,2,
0,0,Ao Hoodie Teelab Color Typo HD040,500000,500000,5,1,4
0,0,Ao Polo tron trang phoi bo voi chat vai xuat du cotton co gian - tham hut - thoang mat - khong nhan,250000,250000,4,1,1
0,0,Quan Boi Lung Nam Phong Cach Chuyen Nghiep Thoi Trang The Thao SZone SQB106,99000,99000,4.3,9,44
0,0,Ao Phong Nam Cotton 100% In Hinh 3D Cao Cap Co Big Size - Ao Thun Nam Ngan Tay Chat Mat Mua He SZone PM70,169000,169000,5,1,2
0,0,Ao thun tay lo unisex phong form rong Wollagee nam nu phong cach ulzzang Wind,61000,61000,5,1,4
0,0,Ao thun tay lo unisex Wind phong form rong cotton PIPIKA nam nu oversize ulzzang,80000,80000,5,1,
0,0,Quàn short nam thẻ thao thuong hiẹu TORANO BW072,199000,199000,4.3,3,5
0,0,Ao thun nam dai tay co so mi SITAKI - ATD01,130000,130000,4.1,16,189
111200,20,OWEN - Ao so mi tráng dài tay regular fit (khong túi ngục) chát soi tre 90527,556000,444800,5,2,
159200,44,"Quan jean nam xanh bac Julido Store, chat jean co dan 4 chieu ton dang nam tinh BC5678",358200,199000,4.6,74,160
0,0,Ao thun Teeworld Harry Potter T-shirt Form Rong Unisex Nam Nu,299000,299000,3.8,4,4
0,0,Ao khoac chong nang nam thong hoi sieu mat,70000,70000,5,14,30
0,0,Quan Kaki Nam QK08,195000,195000,5,1,
8200,10,OWEN - QUAN SIP TAM GIAC OWEN - Sip tam giac chatt cotton,82000,73800,5,4,8
144000,44,"Quan Short Jean Nam co dan kieu dang tre trung don gian Thuong Hieu Chandi, quan sot mau moi xu huong 2021 QSJN217",324000,180000,5,13,35
0,0,"Ao khoac One Piece Ace K05, Ao khoac hoodie Anime Manga One Piece Portgas D. Ace Unisex Nam Nu",220000,220000,5,2,5
127200,44,"Ao Thun Nam Ngan Tay Chandi, Chat Thun Cotton Xin Mau Moi NT23",286200,159000,5,23,77
127200,44,"Ao So Mi Nam lua tron cao cap Thuong Hieu Chandi, xu huong moi nhat nam 2021 mau SM2",286200,159000,5,13,15
0,0,"Ao so mi nam Hien Tran BOUTIQUE giau cuc vai chong nhan, phong cach Han Quoc",249000,249000,0,0,2
60000,27,"Ao so mi tole bong hoa tiet cho nam, ta ngang, tay ngan, big size 105kg, dang rong, thuong hieu Amazing ",219000,159000,5,3,4
0,0,"Ao Thun Nam Phan Quang In mat Mangekyō Sharingan cua Uchiha Madara - toc truong Uchiha - 1 trong 2 nguoi sang lap ra lang La, anime Naruto , ao chat, di dem, di phuot bao ngau, nhin da mat",59000,59000,5,1,6
80000,20,OWEN - Áo so mi trang ngán tay Owen chát soi trang - Ao so mi ngan tay mau trang,400000,320000,5,1,4
0,0,Quan short thun UNISEX Quan short nam nu QS13,69000,69000,4.7,33,81
77000,37,Ao The Thao Nam Polo TSIMPLE co be tay ngan vai thun lanh thoang mat phong cach tre trung chuan form MSSAHCD,206000,129000,5,1,
0,0,"Ao khoac ni AN07 dang dai , Ao khoac nam chat ni lot long kieu dang hoodie phong cach Streetwear doc dao, ca tinh, tre trung nang dong",499000,499000,5,2,5
0,0,Quan lot nam dang luoi goi cam chu T - mau den,39000,39000,4.3,4,10
46000,19,Combo 5 quan lot nam Freeman 6039 ,245000,199000,4.1,11,46
0,0,Ao Phong Nam ️️ Ao Thun Nam Tay Ngan Co Be Thoi Trang Cao Cap Mau Moi Hang VNXK To To Shop - ATNTT4,109000,109000,3,1,3
0,0,"Ao khoac gio nam, nu Tvik mac duoc ca hai mat Mau Moi du size den 90kg, 3KG2",195000,195000,4.5,4,6
0,0,  nam xin xo mac cuc mat,127400,127400,1,1,1
0,0,Quan Sot Nam ️️ Quan Short Jean Nam Xam Tron Chat Bo Co Gian Chuan Hang VNXK To To Shop - QSJNM211,129000,129000,5,3,3
0,0,Ao thun polo nam co co be soc ngang ca sau cao cap ND014,149000,149000,4.8,12,35
0,0,Combo 5 Quan Lot Tam Giac Nam Thun Lanh Cao Cap,150000,150000,5,1,4
81000,45,Ao thun polo nam co be phoi cao cap doc dao pigofashion PAHT06 (chon mau),180000,99000,4.2,11,83
159200,44,"Ao Thun Nam Dai Tay Chat Lieu Cotton co gian 4 chieu, tham hut mo hoi tot Thoi Trang Men Luxury TLB2",358200,199000,5,1,2
0,0,Set do Haori nam Kimono Yunhe Jiuxiao phong cach Nhat Ban sieu chat BSK05,192500,192500,5,1,1
0,0,HOT BST AO FREE FIRE DEP GIA RE KEM BIT MAT FREE FIRE CUC NGAU,139000,139000,4,1,1
0,0,HOT Mua ao khoac E tang kem ao thun bit mat duoc game thu yeu thich nhat,189000,189000,5,1,1
0,0,Quan Jean Nam Chat Bo Den Tron Cao Cap Co Dan Phong Cach Thoi Trang ms27,137000,137000,5,1,1
113600,20,OWEN - Áo so mi dài tay Owen regular fit màu den tron 90646,568000,454400,5,2,3
0,0,AO SO MI NAM HAN QUOC CAO CAP IN TOAN HOC MOI LA,99000,99000,3.7,3,51
0,0,"Quan Jean Nam dang om tre trung, sang trong hoa tiet theu tui sau noi bat, chat lieu vai Bo Cotton cao cap, co gian mac thoai mai, hop xu huong thoi trang - Mau HOT",360000,360000,4,3,5
71000,39,Ao phong ao thun nam ngan tay co co kieu phoi co ban TKAB20 PigoFashion chon mau,180000,109000,4,1,5
0,0,Ao thun Nam body thoi trang,220000,220000,4.8,6,13
0,0,Quan dui nam ong suong cao cap,99000,99000,3.7,15,37
0,0,Bo Quan Ao Dui Nam Den Dang Vua Phong Cach SETDEN99,169000,169000,4.6,16,28
0,0,Ao So Mi Soc Ke MEN SAIGON ( Ma:N6935 ),319000,319000,5,2,2
0,0,Ao thun nam unisex phong rong hoa tiet sieu hot (UX-05-41),49000,49000,4.6,76,182
30000,40,Quan Lot Dui Nam Boxer Cao Cap QLD02,75000,45000,3.3,3,12
0,0,Quan Jogger the thao Nam 9 tat ong bo theu hoa tiet phia truoc mang phong cach Han Quoc tre trung dang om body chat lieu vai lanh cao cap co gian nhe mac thoai mai hop xu huong thoi trang - Mau HOT,220000,220000,4.6,5,13
0,0,Do ngu nam cotton 9936,275000,275000,4.8,5,19
0,0,Ao khoac nam KWIN KJK002W9,850000,850000,5,1,1
0,0,SET AO DOI NAM NU - DO CAP TINH YEU SOC CARO GOM SET DAM NU AO SO MI NAM - SMICE HOUSE,329000,329000,3.5,4,9
0,0,"Ao so mi ke soc thoi trang nam,ao so mi nam cao cap phong cach nam tinh 3 mau, dang ao om nhe tre trung, chat vai tho day dan mem min, khong bi bai xu, size tu 50-75 kg",0,159000,3.7,9,
0,0,"Do bo Pyjama mac nha Nam chat lieu phi bong ru mem mai, soc tre trung -88217",219000,219000,4.6,14,28
0,0,AO KHOAC NAM THU DONG DEP,219000,219000,5,4,11
40000,31,QUAN SHORT KATE SPANDEX FEZZIO 100% COTTON CHINH HANG FZ-05 NEO,129000,89000,4.8,5,
0,0,Quan lot nam Body cotton,75000,75000,5,1,2
71000,30,Ao thun nam co be dai tay chuan phong cach Pigofashion PG09 (xam Dam),240000,169000,3.8,6,67
0,0,Quan Lot Giay Nam Procare TC Luxury - Trang,49000,49000,5,4,351
0,0,Quan jean nam vay son dsq cao cap hang quang chau chuan shop mau moi nhat Phuongnamshop kva1,127500,127500,5,2,3
0,0,"Ao thun nam co be ngan tay, ao polo nam cao cap tre trung chat ca sau tham hut mo hoi",105000,105000,3.7,3,10
0,0,"(ANH + CLIP THAT) Ao thun Luffy, ACE, Sabo Vai Cotton Thai Mau Moi | Ao Phong One Piece Tshirt OP44",0,129600,5,3,
0,0,Ao khoac jean nam tron cao cap vai jean denim khong nong hang chuan shop Phuongnamshop20 rkv4,160000,160000,3,1,2
0,0,Quan jean nam den was cao cap ,289000,289000,4.5,5,13
0,0,Combo 2 goi Quan lot mien giat TC Luxury Procare Nam ,98000,98000,5,2,20
0,0,Ao Tay Lo Unisex Phan Quang Form Rong Vai Min Du size - Naruto_ Phong An 3 phay,51000,51000,5,1,
0,0,{SIEU PHAM MUA DONG} AO KHOAC NAM /AO KHOAC NAM NI NGOAI LOT LONG GIU NHIET SIEU AM AP CHO MUA DONG CO SIZE 3XL VINA 1HI,169000,169000,1,1,1
0,0,"Ao thun nam nu form rong Yinxx, ao phong tay lo ATL81",69000,69000,4,1,2
0,0,Ao So Mi Nam Cao Cap Phoi Soc Hoa Tiet Theu Kieu Dang Thoi Trang Han Quoc,198000,198000,1,1,2
0,0,quan short jean nam  hang big size duoi 85kg ,125000,125000,5,5,12
0,0,Ao khoac jean nam cao cap phong cach han quoc nam tinh KN1,235000,235000,3.7,11,23
0,0,Quan tay nam nu dong phuc hoc sinh cap 1 cap 2 ,70000,70000,4.2,5,50
81000,41,Ao so mi nam caro cao cap ngan tay Hahaman HM29 mau trang xanh,200000,119000,4.7,3,7
0,0,Bo Quan Ao Nam Dai Vai Ni Da Ca 2 Mau,275000,275000,4.3,3,14
0,0,"Ao Thun Nam Ba Lo Cotton Sat Nach, Tank-Top dap van Form Rong, Tap Gym Co Tron Co Dan Cao Cap",119000,119000,5,7,15
0,0,Combo 3 Quan Lot Nam JME JM046,149000,149000,4.5,2,86
0,0,Ao thun nam vai ca sau CB07 (xám),155000,155000,4.3,7,21
115000,38,Ao Khoac Du Nam Co Dung 2 Mat Phoi Mau Cao Cap 2mpm03,300000,185000,4,5,20
0,0,Ao so mi dui nam chat mat,89000,89000,3.5,13,124
0,0,Quan Lot Nam Tam Giac Seamless Coral,105000,105000,5,3,22
0,0,QUAN LOT ROSSO NAM DET KIM CAO CAP MAU XANH DEN - MEN UNDERWEAR - 0004,90000,90000,4.5,2,6
182000,48,COM BO 2 AO 3 LO COTTON RIP 4 CHIEU 100% COTTON FEZZIO,378000,196000,4.3,7,8
0,0,"So mi co Tru loai dep chong nhan, Ao so mi co Tru chat lieu lua mat",79000,79000,4.3,6,13
0,0,Ao thun nam form rong chat cotton loang mau cuc hot,99000,99000,4.7,3,4
0,0,Ao Thun Nam Dai Tay Co Tim Phoi Nut Cuc Dep,149000,149000,4.5,5,17
0,0,Combo 3 quan lot nam/ sip nam cao cap - mem min sieu thoang - H04,90000,90000,5,7,13
0,0,Quan dai the thao nam Jogger 3 soc lung ong bo tre trung nang dong Micado,75000,75000,5,2,14
0,0,"Ao len cao co nam dang om ArcticHunter, thoi trang phong cach Han",250000,250000,4.2,5,23
0,0,"Quan boi nam dang lung, mau moi 2020, vai boi day dan dep, co gian 4 chieu | BN005",115000,115000,4.5,16,63
0,0,"Ao Khoac Nam, Ao Gio Nam 2 Lop Lot Long Cuu CARDINA Cao Cap Sieu Nhe, Sieu Am",400000,400000,2,3,3
0,0,Ao Hoodie tron Chat ni ngoai day dan cho teen phong cach,39000,39000,0,0,
0,0,Do Bo Nam theu logo - Bo nam ke soc phoi mau mau moi,135000,135000,4,1,2
0,0,"Ao thun nam co tru GOKING, cong nghe det nhuom cao cap Nhat Ban",165000,165000,4.7,24,36
0,0,Ao Thun Teelab Poker Dong Nghien Collection TS109,195000,195000,5,1,4
0,0,Ao thun Phan Quang Tay Lo Nam Nu Beerus,95000,95000,4,1,1
0,0,"(HOT TREND) Quan nam Quan dui dai nam ong con cap chun day rut, CHAT NHE , MAT, THAM HUT MO HOI",99000,99000,3.8,6,23
0,0,Ao phong nam tay ngan co tron chat cotton in hoa tiet cuc dep,39000,39000,4.3,42,98
79200,44,"Ao thun nam co be tay ngan tre trung, chat lieu cotton cao cap mau THUU36",178200,99000,4.3,18,40
0,0,AO KHOAC DU NAM IN NGUC DON GIAN,89000,89000,3,1,3
0,0,Bo 3 ao thun body co tron nam Taki Taki,165000,165000,4.5,2,3
0,0,"Ao so mi nam Xanh Than Vai cheo khong nhan, So mi nam tron dang om",77000,77000,0,0,
0,0,Ao thun tay dai nam ️️ Ao thu dong dai tay cotton co gian thoang mat To To Shop - ATNDT1,99000,99000,5,1,10
0,0,Combo 2 chiec Quan ship lot nam thong hoi chat sieu mem mai chuan nam men,70000,70000,5,2,7
0,0,Ao thun nam Ao polo nam ngan tay co co PN01 Cotton 100% cao cap phong cach Han Quoc,125000,125000,4.5,2,2
0,0, QUAN LOT NAM BOXER COTTON THUONG HIEU BOX (HINH THAT),89000,89000,4.3,3,5
0,0,Ao Thun Unisex Bad Rabbit Stripes Ke Hong 100% Cotton - Local Brand Chinh Hang,400000,400000,5,2,5
0,0,Ao thun nam nu co be polo cao cap vai cotton sieu co dan hang chuan shop Phuongnamshop20 m68,89280,89280,5,2,5
0,0,"Ao khoac GIO nam LOT NI SIEU AM 2 Lop Vai Gio Am Ap Can Gio, Chong Nuoc Hieu Qua",450000,450000,5,5,5
0,0,Ao hoodie nam nu - ao mu hoodie ni thu dong phong cach ulzzang nhieu mau chat ni bong day dep HD8,289000,289000,3,2,2
80000,32,"AO CHONG NANG NAM, CHAT LIEU VAI SOI TRE CAO CAP, HANG LOAI 1",250000,170000,4.8,11,19
0,0,Quan Ong Rong Tron NQ30 Ni Da Ca Cap Cao Rach Goi Den Xam Nam Nu Ullzang,105000,105000,4,1,2
102000,51,Ao Thun Tay Ngan Nam Nu URBAN OUTFITS In Chu AMENITY ATR22 Form Suong Cotton 4 Chieu Local Brand,200000,98000,5,2,4
81000,41,Ao so mi nam caro cao cap ngan tay Hahaman HM05,200000,119000,4.3,3,6
0,0,Quan Short Jean Nam Chat Bo Co Gian ️️ Quan Sot Nam Rach Ca Tinh phoi in chu hot trend To To Shop - QSJNM217,139000,139000,5,1,3
0,0,Ao polo ngan tay OWEN Bodyfit - APV21836,450000,450000,5,1,5
0,0,"Ao khoac nam trung nien chong nhan, chong tham nuoc AK09",350000,350000,5,1,4
0,0,Ao khoac du nam co non kieu nang dong the thao phu hop moi do tuoi,229000,229000,4.5,2,5
0,0,"Ao chong nang - Ao chong nang nam, ao khoac di nang chat vai kim cuong co BIG SIZE cho nguoi Dai Beo",109000,109000,4,1,3
0,0,quan noi ong nam Ktom,450000,450000,5,2,6
0,0,"Ao chong nang NAM KE CARO 2 lop, chong nang  tia UV, bao ve ban trong nhung ngay he nang nong",70000,70000,0,0,1
0,0,"Ao so mi nam tay dai, di hoc cap 1, cap 2, cap 3",107000,107000,4,1,2
58800,10,OWEN - Aó so mi dai tay Owen Slimfit chat soi tre ke ca ro xanh 23219,588000,529200,5,1,2
0,0,"Ao khoac thu dong nam nu hinh dau lau phoi tay da sieu sin, kem video anh that",360000,360000,5,1,2
159200,44,"Ao Thun Nam Dai Tay Chat Lieu Cotton co gian 4 chieu, tham hut mo hoi tot Thoi Trang Men Luxury TL1",358200,199000,4.5,2,5
0,0,"Quan tay vai quan tay nam ong con vai dan danh cho hoc sinh, sinh vien co big size tu 26 den 37",135000,135000,5,2,8
0,0,Ao thun BARBOSSA Unisex Infinity Love - 1994 Store,105000,105000,5,1,3
0,0,Ao So Mi Nam Nu Cotton Sieu Mem Min,99000,99000,4,1,1
0,0,AO THUN FOM RONG MUA HE DANH CHO CAC BAN NAM ,55000,55000,1,2,2
0,0,"Ao thun Nam Nu Khong co Meo Meo CIMT-0000 mau moi cuc dep, co size be cho tre em / ao thun Anime Manga Unisex Nam Nu, ao phong thiet ke co tron basic coc tay thoang mat",39999,39999,5,1,6
0,0, Quan Jogger Dui Nam Cao Cap 2020 - QD44+TAT,96200,96200,5,10,14
0,0,Ao khoac long vu ALGALV.10 - mau den,1650000,1650000,4,1,1
0,0,"SET BO THU DONG UNISEX HOA TIET SIEU VIP , MOI LA CHO CAC BAN TRE VINA FASHION",135000,135000,1,1,
0,0,Ao len nam co lo mau moi nhat 2020,199000,199000,0,0,7
0,0,"Quan Short Jean Nam, Quan Bo Ngo Nam Cao Cap Mau Moi Sieu Dep OBOK Fashion QSN3334",149000,149000,5,1,5
0,0,COMBO 2 CHIEC QUAN SIP NAM TAM GIAC CAO CAP KHONG DUONG MAY CO DAN MAU MOI - MAC THAI,117000,117000,3.3,3,8
0,0,(SALE) Ao thun lien quan mobile - Trieu Van Bang Thuong,99892,99892,1,1,3
0,0,Quan lot nam cao cap - Hop 5 quan lot,99000,99000,0,0,
0,0,"Ao thun nam phong tron Casual 1st co tron tay ngan coc, vai 100% cotton cao cap thoang mat, tham hut mo hoi, form ao tre trung thich hop di lam, di choi, dao pho, du lich, Made in Vietnam - NEWYORKCITY",250000,250000,4.7,3,10
0,0,Quan short Kaki Nam Nu Unisex ong suong mau TRANG/ DEN/ TAN/ NAU,125000,125000,5,1,1
0,0,Quan Lot 2 nguoi sieu co gian quyen ru cho cap doi,47000,47000,4,1,1
0,0,"{ANH CHUP THAT} Do bo Pijama-Do ngu nam cao cap phong cach Han Quoc, chat COTTON 100 day dan & thoang khi (713)",420000,420000,5,1,5
15000,50,"Quan Lot Nam Tam Giac Chat Co Gian Thoang Mat Cap,Mau Ngau Nhien",30000,15000,4.5,2,14
0,0,"Quan Short Gio , Quan Dui Nam The Thao Chat Vai Dep Form Rong Mau Xanh Den The Thao Nam Tinh Cao Cap Big Sport",120000,120000,4.5,13,26
0,0,"Ao thun thoat nhiet Goking in 3D cao cap. Hang hieu thoang mat, tham hut mo hoi, khu mui, khang khuan",188000,188000,4.7,22,41
0,0,Bo The Thao Nam Bo Thu Dong Nam Chat Ni Da Ca Day Dan Cao Cap Form The Thao Tre Trung Nang Dong ,240000,240000,1,1,1
0,0,"Ao khoac alanwalker , ao hoodie alanwalker, ao khoac nam , ao khoac nam tre em , ao khoac nu , ao khoac cap doi , ao alanwalker size nguoi lon va tre em ",79000,79000,2.5,2,7
0,0,"Quan Short Nam Thun Poli Phoi soc vien Lung Thun , Quan dui nam Kieu Dang The Thao Tre Trung Nam Tinh-LEE’S HOME",92000,92000,5,8,10
0,0,"{DUI MOI HANG VE} Bo quan dai tay ngan, Hang chuan chat, Chuan phom dang, Dui thai chuan 100%, Day dan, Cuc thoai mai!!!",197000,197000,5,7,18
0,0,Quan khaki nam cao cap chinh hang Aristino AKKR0109,695000,695000,4,2,3
120000,25,"Quan tay truyen thong Amazing, ong xuong, khong ly, vai day co van chim, tham hut tot, co size lon 105kg",489000,369000,5,5,16
159200,44,"Quan Jean Nam dep dan dau xu huong Thuong Hieu Chandi , mau moi form dep ton dang khong qua om MR9045",358200,199000,4.7,24,26
0,0,Combo 3 quan nam,105000,105000,3,1,3
0,0,Sip Dui- Quan Lot Nam Boxer Cotton Sieu Mem Form To Thoang Khi Hoa Tiet Chu 3D K459,50000,50000,5,1,3
0,0,Ao len nam tieu day van thung mau moi Quang Chau BITULA,180000,180000,4.3,3,9
0,0,"Quan lot nam Modelfashion - 4113, Vai thun lanh mem mat, co gian form thoai mai -8250",39000,39000,3,1,
0,0," Quan Jean Nam Suong, Quan Jean Ong Rong - Ma 1303",159000,159000,5,1,3
0,0,Ao khoac ni 2 da thoi trang SITAKI ,325000,325000,1,1,2
0,0,AO THUN NAM CO BE PHOI SOC DEP CO GIAN 4 CHIEU,149000,149000,1,1,2
0,0,"Ao ba lo nam MDLON - Tank top the thao chat cotton co dan tot, mem min mat me",69000,69000,1,1,2
0,0,"Quan tay nam trung nien dang suong, ong rong vai nhap khau cao cap",350000,350000,1,1,11
0,0,"AO KHOAC DU NAM FORM RONG 2 LOP PHOI MAU DI MUA,CAN GIO, CHONG NANG",67000,67000,1,1,4
0,0,AO KHOAC DU NAM 2 TRONG 1 ,229000,229000,4,6,53
0,0,"Quan short kaki nam ngan Santino, chat lieu cotton cao cap co dan nhe, dang xuong thoai mai SRG385A106",385000,385000,4.5,6,8
0,0,"Quan Sip Dui Boxer nam FEAER form om thoai mai, Chat Cotton SIEU THOANG - FEAER DENIM",149000,149000,5,2,
0,0,"Ao Thun Nam_ Nu  Phan Quang In hinh ASIANS DRAGON , ao chat, di dem, di phuot bao ngau, nhin da mat",60000,60000,4.5,31,53
0,0,Bo Quan Ao Ran Ri Linh My US ARMY Tui Hop Chien Thuat [Tang That Lung],449000,449000,4,5,22
0,0,Quan Short Jean Nam Chat Bo Co Gian️️Quan Dui Nam Rach Nhe Ca Tinh (kem hinh that) To To Shop - QSJNM251,129000,129000,5,1,1
0,0,Ao Thun Nam Phan Quang 7 Mau Let's Race,60000,60000,4.7,6,12
0,0,Ao thun linh ran ri phong cach quan doi,99000,99000,3.8,8,26
0,0,"Quan dui coc the thao nam co dan nhe logo ln Han quoc, quan mac nha di choi tap the thao nang dong thoai mai",90000,90000,4,1,6
0,0,"Ao thun Polo nam co be  vai ca sau may ki , form dep PL T07 - SoHa Clothing",210000,210000,5,1,1
0,0,CATSA Ao Polo phoi mau vang xanh den,350000,350000,5,1,
0,0,"Quan Jean Nam Den cao cap thuong hieu Chandi, phong cach ton dang nam tinh chat jean AA1",199000,199000,4.5,2,5
0,0,Ao Len Nam Co Lo Loai Day Bs58,396000,396000,4,1,1
61000,27,Ao thun nam Polo co phoi bo det dep chuan Xmen pigofashion cao cap PAHT08 (Chon Mau),230000,169000,4,15,293
0,0,Quan jean thun lung nam cao xuoc hang dep,250000,250000,4.2,5,17
0,0,Ao Thun Co Tron Unisex Nam Nu Basic 19 Mau Medium Size,129000,129000,4.6,31,496
0,0,Ao so mi trang ngan tay Viet Tien 420,420000,420000,4.8,4,18
0,0,Ao Khoac Ni Chong Nang Cao Cap-Hang 2 Lop,215000,215000,2.8,6,41
0,0,Ao so mi Hoa tiet TITISHOP SM1120,350000,350000,5,1,2
0,0,Quan Short Kaki Q159 cap lung thun Loai Tot MD (Den) thoi trang,85000,85000,3.5,2,5
0,0,Ao So Mi Nam Co Vest Den Dang Han VESTDEN99 (Vest Den),59000,59000,3,2,2
0,0,Quan Kaki Nam Ghi Dam KAKIXAM99 (Kaki Xam),94000,94000,3,28,236
59000,50,AO THUN NAM CO TRON TRON COTTON CO GIAN 4 CHIEU,118000,59000,0,0,
177000,30,OWEN - Ao so mi dai tay Owen SLIMFIT vải sọi tre 90036,590000,413000,3,2,4
0,0,[ROUTINE] Quan jean nam - Quan Jean nam mau den form slim fit (rong vua) co do co gian,450000,450000,5,1,2
0,0,Quan Kaki Nam Han Quoc Den,120000,120000,5,1,1
159200,44,"Quan Jean Nam cao cap co dan 4 chieu Thuong Hieu Chandi, phong cach han quoc tre trung ca tinh MR9017",358200,199000,5,27,47
0,0,AO LEN NAM AO LEN VIET CAO CAP AO LEN CO LO - AL7116,150000,150000,5,2,8
0,0,Ao Coc Tay Nam Trang Min Chat Mat THUNTRANG04,69000,69000,3,1,
0,0,Ao len nam co lo ,155000,155000,5,2,2
40000,20,"Ao so mi dui nam co tau 5 khuy tui nguc gia LAHstore, chat vai dui thoang mat thich hop mua he thoi trang tre, phong cach Han Quoc",205000,165000,4.5,6,12
50000,15,"Ao khoac len nam co tru tre trung, chat len tran bong 2 lop day dan, thoi trang phong cach lich lam",340000,290000,1,1,4
0,0,Ao Thu Dong Nam Dai Tay - Chat Ni Da Ca cao cap hot nhat 2021 N06,130000,130000,4.7,3,4
50000,15,"Ao khoac cardigan len nam muoi tieu co tru 2 lop, len 2 lop tran bong am ap, thoi trang phong cach tre",340000,290000,5,2,8
20000,34,Ao Thun Nam Dai Tay Giu Nhiet Form Body The Thao Chat Thun Co Gian Giu Am Tot 16,59000,39000,4,2,3
144000,44,"Quan Short Jean Nam co dan kieu dang tre trung don gian Thuong Hieu Chandi, quan sot mau moi xu huong 2021 NT310",324000,180000,5,7,23
127200,44,"Ao Thun Nam Ngan Tay Thuong Hieu Chandi, Chat Thun Cotton Xin Mau Moi NH10",286200,159000,4.6,20,86
0,0,"Bo quan ao giu nhiet nam,bo giu nhiet nam, quan ao giu nhiet lot nhung am ap",139000,139000,2,1,3
45000,12,"Combo 3 Chiec Quan Lot Nam Boxer Cao Cap, Quan Lot Nam Det Lien, Co Dan 4 Chieu Kwin KBX1711 - Hang Chinh Hang",375000,330000,4.5,19,54
0,0,"Ao khoac da nam dang dai tui cheo 1 cuc LAHstore, thoi trang tre, phong cach lich lam",479000,479000,3.6,12,25
74000,26,Ao phong nam cao cap co tron ngan tay dep chat vai cotton co gian 4 chieu thoang mat ZAVAS  Z04,289000,215000,5,3,8
0,0,Ao thun Highclub Basic Tee,150000,150000,5,2,8
0,0,"combo 3 quan sip boxer nam cao cap, quan sip dui nam cao cap",145000,145000,3.6,12,41
0,0,Ao Thun Nam Ca Sau Co Be Co Gian 4 Chieu,119000,119000,3.6,16,68
0,0,"Ao One Piece Luffy ATT-05, Ao thun Anime Manga One Piece Monkey D. Luffy Unisex Nam Nu",95000,95000,4.5,14,20
0,0,AO KHOAC DU NAM PHOI CUC DEP,209000,209000,4.3,3,9
0,0,Ao khoac du cardigan unisex form rong Mat Cuoi nam nu ,89000,89000,5,1,2
0,0,"Ao Thun Nam_ Nu  Phan Quang In hinh KING , ao chat, di dem, di phuot bao ngau, nhin da mat",60000,60000,3,2,2
0,0,"Ao thun Nam Nu Khong co 7 VIEN NGOC RONG LICK-TEN  MSOP-16 mau moi cuc dep, co size be cho tre em / ao thun Anime Manga Unisex Nam Nu, ao phong thiet ke co tron basic coc tay thoang mat",35000,35000,5,1,1
0,0,"Ao thun Nam Nu Khong co ONEPIECE TEAM MU ROM  MSOP-24 mau moi cuc dep, co size be cho tre em / ao thun Anime Manga Unisex Nam Nu, ao phong thiet ke co tron basic coc tay thoang mat",39999,39999,5,3,3
0,0,Ao Thun tay lo Nam Nu Unisex co tron in chu Sad Boiz ao phong ngan tay khong co vai co gian khong nhan,99000,99000,4,1,2
0,0,️️ Ao thu dong nam dai tay co tron dang body thoi trang,99000,99000,5,1,
0,0,"[TUYET CHIEU ] Quan Sip So Vin Thong Minh cao cap AJIKO, Cuon Hut, Doc Dao.",150000,150000,5,1,10
159200,44,"Quan Bo Nam cao cap thuong hieu Chandi,  chat jean co dan mau moi 2021 ma HD54",358200,199000,5,32,47
11000,10, Bo thun the thao mua he phoi mau thoang mat BTP01070,110000,99000,5,3,
100000,50,"BO THUN THE THAO NAM HAHAMAN ,GYM THEU LOGO CAO CAP BTT0607 mau vang",199000,99000,5,1,
0,0,Quan Boi Nam 2 Lop Khong Xuyen Thau Thong Thoang Thoai Mai 469,109000,109000,4.5,34,148
0,0,"Bo quan ao he nam co tau cao cap chat DUI mat min, nhe nhu khong",197000,197000,2,4,6
0,0,Ao Thun Nam Everest AokNAM411 - Cam,199000,199000,5,1,23
0,0,Ao Thun Nam In Hinh Everest AoKNAM243 (Cam),226000,226000,5,7,13
0,0,Ao Thun Nam In Hinh Paris Everest AokNAM418 (Do),235000,235000,5,1,29
0,0,Ao Thun Nam Couple TX In Thong Diep Chuyen Mau MTS 1064,279000,279000,5,1,2
0,0,QUAN SHORT AU NAM - Kem - 30,135000,135000,0,0,26
0,0,Ao So Mi Nam Phoi Mau Chuan 4D Cao Cap,129000,129000,1,1,2
61000,47,Ao thun nam ngan tay khong co co gian TKGM06 PigoFashion nhieu mau lua chon,130000,69000,5,8,11
0,0,Ao Phong Doan Thanh nien nam nu,95000,95000,5,3,20
61000,47,Ao chong nang THONG HOI NAM co Bigsize,130000,69000,5,2,4
94000,29,"Ao khoac du nam Lados co non khong theu Lados - 12030, chong truot nuoc tot",329000,235000,5,2,4
0,0,Quan Shorts Kaki Nam Vai Dep LD42,55000,55000,4,14,38
0,0,Quan Jeans Dai Ong Suong Trung Nien LD34,129000,129000,3,1,1
0,0,AO KHOAC NHUNG BOMBER UNISEX NAM NU THOI TRANG MOI KME,155000,155000,4,1,2
0,0,Ao chong nang NAM KE CARO 2 lop- tre trung- khoe khoan- tien loi.,69000,69000,5,2,8
0,0,Ao khoac phao nam giu am chong gio lanh mua thu dong thuong hieu doka PHAO08,329000,329000,3.7,3,18
0,0,bo ni cho bo bo ni the thao nam trung nien loai dep,390000,390000,5,1,1
0,0,"Ao khoac gio danh cho nam, nu chong nang, chong nuoc 2 lop thoi trang cao cap- G01",145000,145000,3.6,14,37
0,0,"Quan Jean Nam Co Lon Danh Cho Nguoi Beo, Nguoi Map - Quan Jean Ngoai Co Cho Nam Size 36-48 - Mau Den",589000,589000,5,1,1
0,0,Ao nang THONG HOI NAM - bao ve tot da cua ban,66000,66000,5,1,6
0,0,Ao Giu Nhiet Nam co cao Khu mui Nano bac,99000,99000,3.9,25,67
0,0,Ao Thun Nam Vai Dui Coc Tay Co Tau Kieu Dang Sang Trong,129000,129000,5,1,5
31000,16,Ao khoac du nam 3D phoi non lot luoi cao cap Bonado AKD40,200000,169000,4,4,9
0,0,Bo The Thao Ngan Mac Nha Nam ROUGH Tre Trung Thoai Mai,150000,150000,4.7,7,12
99000,42,Bo do the thao nam THE 1992 Bo quan ao nam cao cap ke soc,238000,139000,4.5,2,13
72000,40,QUAN OI NAM TAM GIAC QT359,180000,108000,2,1,
0,0,Ao khoac du nam 2 lop 2 mat chong nuoc cao cap BN93,169000,169000,4.5,6,15
120000,40,Ao so mi dui nam co tau linen tay ngan BD1310 - Trang,300000,180000,4.5,4,21
0,0,Quan short jean nam  - KHANG297,99000,99000,5,2,2
0,0,"Quan Dui Nam Dai Ong Con Cap Chun Day Dan Thoáng Mát, Co dãn 4 chièu thám hút mò hoi",225000,225000,4,1,1
73000,50,Do bo nam nu unisex mua he chat me xin co gian 4 chieu thoang mat,146000,73000,4.5,2,4
0,0,"Quan jogger nam tui hop chat kaki mem min, phong cach duong pho RFE",118000,118000,5,2,4
0,0,"Ao Thun Nam Unisex trang den In GKKRT, Ao Thun Tay Ngan co tron Dang Rong tay lo Hoa Tiet In phong cach tre trung, ao thun hoat hinh nam nu, ao thun ulzzang unissex dep",80000,80000,5,2,6
0,0,"Ao khoac nhung kieu bomber theu logo EOHFFRU thoi trang, Ao Khoac Nhung Theu Logo Kieu BomBer , Ao bomber jacket nhung, Ao khoac nhung nam nu / ao khoac nam nu / ao khoac form rong",175000,175000,4,1,1
75000,44,Ao thun longtee tay dai,170000,95000,2.5,2,3
144000,48,"Ao khoac bomber nhung chu D phom rong freesize Cheapy unisex, Ao Bomber Chu D Dang Unisex Hang Shop Chat Ni Nhung tam unisex dang sieu cool ngau, Ao Khoac Bong Chay nhung Gio Phong Cach Han Quoc From Rong Dang Thung",300000,156000,1,1,1
75000,44,"ao thun ,tay lo from rong in noi con cai nit- phong nam nu unisex chat cotton hot trend chinh hang - ao thun sieu pham in 5D cuc dep, Ao thun tay lo nam nu in chat thun cotton co gian khong bong troc",170000,95000,4,1,1
0,0,Quan KaKi Kieu Dang Jogger Ran Ri Nam Co Gian 4 Chieu Cao Cap M05,96600,96600,3,7,18
0,0,"<HOT> Ao khoac du bomber nam nu unisex form rong vai 2 lop chat xin, day dan, y anh phong cach han quoc (xucxac))",95000,95000,5,2,2
0,0,Ao so mi nam Ngan Tay Mau Den,79000,79000,3.5,12,23
0,0,Ao thun DAI TAY Unisex N7 Basic Tee phong tron nam nu lo oversize form rong sweater ulzzang Han Quoc,125000,125000,5,1,10
75000,50,"Bo do nam y hinh, vai em, mat, khong ra mau, khong do long (unfollow)",150000,75000,3.9,10,36
0,0,AO KHOAC KAKI NAM NU TUI HOP 03 MAU FORM RONG,133000,133000,1,1,3
0,0,"Quan jogger kaki nam dang the thao cao cap, quan jogger nam kaki thoi trang, dang om body, bo chun ong chan, khong xu khi giat may",68000,68000,3,1,6
0,0,Bo quan ao the thao nam nu in Uzumuki,75000,75000,5,1,1
0,0,Bo quan ao the thao thun lanh ba soc nam nu,75000,75000,5,1,3
0,0,Bo quan ao the thao nam,67000,67000,4.3,3,3
75000,50,"Set Bo the thao nam y hinh, vai em, mat, khong ra mau, khong do long",150000,75000,4.5,4,5
0,0,"Ao khoac Hoodie  hoat hinh unisex, Ao hoodie ni bong in hinh nam nu cap doi mac sieu cute -from rong khoac hoodie nam Unisex , Ao hoodie nam nu mac in/ ao sweater nam nu mac / ao thun ao form rong / ao cap doi / ao khoac",108000,108000,4,3,6
0,0,Quan Lot Nam Jockey Dang Trunk Ban To Thun Cotton - JAMB0411,125000,125000,4.1,17,65
0,0,"Ao HOODIE NAM NU DEN TRANG VAI NI PE DAY Unisex hoodie,AO KHOAC HOODIE NAM UNISEX AO HOODIE NI PHOI HAI MAU CUA NAM CHAT NI AM AP",110000,110000,4,1,1
0,0,Ao Sweater Nam Nu | Ni Bong Trang  Tron Thoi Trang Cao Cap,79000,79000,4.5,22,74
0,0,"DO BO MAC NHA NAM THUN LANH IN HINH HOAT HINH SIEU DANG YEU CHO CAC BAN TRE , DO BO MAC NHA MUA HE THUN LANH MAT ME CO GIAN TOT, THOI TRANG PHONG CACH - JINS STORE",94000,94000,4,1,2
0,0,Bo do Nam The Thao cao cap NX1,97000,97000,5,1,3
0,0,"Bo the thao nam chat dep btt sport, Bo quan ao the thao nam Sport chat thun lanh - set bo mac nha nam nu thoai mai",86000,86000,2,3,5
0,0,Quan jocker mui ten nam nu,62000,62000,0,0,
0,0,Ao Thun Tay Lo Unisex AMERICAN DREAM 100% Cotton - HADES Brand Chinh Hang					,380000,380000,4,1,3
0,0,AO KHOAC DA NAM LOT LONG 2 MAU VANG BO VA DEN KEM HINH CHI TIET SAN PHAM ,429000,429000,5,1,3
0,0,Quan jean nam mau den vien trang ca trang mau moi sieu dep,134000,134000,3,2,3
0,0,Quan Sot Kaki Lung Bo Vai Co Gian Cho Nam SKKLB1,119000,119000,5,1,12
0,0,"Ao gio nam nu chong nuoc ,bui ban,chong bam bui,ao doi nam nu di phuot",99000,99000,5,1,12
0,0,AO KHOAC NAM NI NGOAI LOT LONG GIU NHIET BAO DEP SIEU AM MUA DONG,250000,250000,3.8,124,347
0,0,( Xa hang gia tot ) BCT Bo dui nam dep phong cach Han quoc!,159000,159000,5,3,8
0,0,Quan Dui Nam mac nha 5S Vai Gio Quan the Thao Short Nam Chun Mem Mai - MINHSTORE,52000,52000,3,3,26
0,0,"AO KHOAC KAKI NAM CUC CHAT PHONG CACH , SIEU XIN , CHAT , NGAU CHO ANH EM THOI TRANG LANO STORE",199000,199000,2.3,3,6
20000,29,"Quan jogger ni bong ( hinh that ), quan jogger nam, quan ni nam, quan ni nu, quan the thao,quan the thao nam,quan jogger",69000,49000,0,0,1
0,0,Áo thun nam dai tay RBCNCP ,85000,85000,3,1,12
0,0,"Ao Thun Nam Phan Quang In hinh MAT QUY CUOI , ao chat, di dem, di phuot bao ngau, nhin da mat",59000,59000,5,8,18
0,0,Ao phong nam cotton usa 8TS21A001 Canifa,129000,129000,4.8,43,116
0,0,Combo 2 Quan Lot Nam JME JM038 (Freesize),139000,139000,5,1,8
0,0,"Do bo the thao nam co dan, tham hut tot, thoang mai King168 , do the thao nam MT54",0,200000,1,1,
0,0,Ao so mi nam tay dai SMH102,125000,125000,3.8,9,24
0,0,"Quan Jean Nam cao cap King168, thoi trang xu huong HD4",0,159000,5,1,
0,0,"Quan Jean Nam thiet ke the thao cao cap nam King168 , Quan Jean thoi trang cao cap nam NT190",0,159000,5,2,
0,0,"Do bo nam cotton King168, bo nam mac he mat me khong phai mau khong xu mau Vq16",0,150000,2.7,3,
0,0,"Ao khoac jean nam King168 , ao khoac bo cao cap AK21",0,250000,1,1,
0,0,"Bo thun nam King168 , do bo nam cao cap MS2059",0,150000,1,1,
0,0,"Ao khoac ni nam thoi trang cao cap King168 , ao khoac ni cao cap nam C01",0,180000,1,1,
0,0,COMBO 5 AO THUN NAM IN HINH VAI DAY MIN HAN QUOC,178000,178000,4.8,4,6
0,0,Ao hoodie tron khoa keo,135000,135000,5,1,2
0,0,( Jean day) Quan Jeans Nam -  Quan Baggy Nam Thoi Trang Unisex- Phong cach thoi trang han quoc,132000,132000,3.1,37,98
0,0,Ao khoac da nam thoi trang Quang Chau,445000,445000,3.1,7,12
0,0,QUAN SHORT JEAN NAM CO GIAN MAU TRON - GV5271 - 29 - DEN TRON,94000,94000,4,2,2
0,0,"AO SO MI NAM TAY DAI CUC CHAT SIEU HOT , CARO , HOT 2021 THOI TRANG KING FASHION",125000,125000,4,2,9
0,0,Ao Dui Nam Dai Tay Co Tru Cuc Tet Nep ROUGH,119000,119000,4.7,3,24
0,0,Ao khoac Unisex jean nam A291 (Den),59000,59000,3.5,4,18
0,0,"AO KHOAC DU , AO KHOAC DU NAM CUC CHAT , CO MU CHE NANG SIEU DEP NGAU NHAT 2021 THOI TRANG MOI KINGSHOP79",79000,79000,3.5,4,15
51000,30,Ao thun nam polo ngan tay co co vien phoi bo TKAHT22 PigoFashion chon nhieu mau,170000,119000,4.8,6,9
0,0,Bo the thao nam phong cach hoa tiet chu thai vai thun lanh co gian sieu thoang tui co day keo va day rut da nang hot triend 2021 - bo chu thai,88000,88000,4,1,2
0,0,"Ao Polo nam co be ngan tay, chat lieu vai ca sau cotton cao cap, tre trung, nang dong – FORMEN SHOP – FMPS046",199000,199000,5,1,3
0,0,Ao Ba Lo Co Vuong Nam SZone,59000,59000,3.8,11,55
0,0,QUAN JEAN NAM DAI RACH,189000,189000,5,1,3
0,0,"Sip nam dui chat cotton cao cap,4 mau full size den 88kg",55000,55000,2,4,24
161000,64,Ao khoac ni nam giu am cao cap Pious NI04,250000,89000,4,18,112
0,0,Quan tay nam viet tien mau xanh den regular fit 0ly 8P4096-8P4028,580000,580000,3.3,3,6
51000,15,Ao Khoac Phao Long Vu (30%) Nam Nu VNXK sieu nhe chong nuoc giu nhiet tot kieu dang tre trung Han Quoc,350000,299000,5,1,1
0,0,Quan The Thao Nam Thu Dong Co Gian Cao Cap - QTT03,78000,78000,0,0,7
51000,39,Ao thun nam dai tay khong co kieu the thao co gian TKADT04 PigoFashion chon nhieu mau,130000,79000,5,3,15
279000,50,OWEN - Áo So mi dài tay Owen Slimfit mau do do 80830,558000,279000,5,2,6
0,0,AO KHOAC DU NAM 2 LOP HOA TIET  AGURA SIEU CHAT ,159000,159000,4.3,28,687
0,0,(VIDEO ) AO KHOAC DU 2 LOP CO NON THOI TRANG NAM NU,95000,95000,5,1,
0,0,QUAN SHORT JEAN NAM MAU XANH DAM WASH NHE PHONG CACH SANG TRONG,170000,170000,5,2,3
0,0,Bo The Thao Nam Dai Tay - Bo Thu Dong Chat Lieu Ni Cao Cap Mem Min - BD07,230000,230000,3,2,1
100000,42,Ao thun DAI TAY Unisex E'mer I DON'T SMOKE Basic Tee Ao Phong Nam Nu Lo Oversize Form Rong Sweater Ulzzang Han Quoc,239000,139000,4,1,
0,0,Quan Short Nam Rach️️ Quan Short Bo Nam Cao Cap - Sot Jean Co Gian Mau Moi Hang VNXK To To Shop QSJN05 -Ma 218,118000,118000,3.7,3,8
0,0,Ao Khoac Ni Nam Day Dan Co Non,220000,220000,4.5,2,11
0,0,Ao thun nam form rong in hinh ho tiet moment dep,79000,79000,3,2,
51000,51,Quan dui nam mac nha mau ngau nhien Q04,100000,49000,4,35,427
0,0,Ao len nam nu co lo,125000,125000,4.5,11,60
0,0,Ao khoac len nam a776,345000,345000,5,2,6
0,0,Ao Thun Nam Trang Min Han Quoc THUNTRANG99 (Thun Trang),74000,74000,4,1,4
0,0,"Ao Thun Nam Phan Quang In hinh DAU LAU , ao chat, di dem, di phuot bao ngau, nhin da mat",59000,59000,4.3,3,4
0,0,"Quan jean dai nam, quan bo nam mau trang tre trung phong cach de phoi do",139000,139000,5,1,4
0,0,Ao khoac mang to nam tre trung thoi trang moi NMT74,1080000,1080000,4,2,5
81000,41,Sweater dai tay nam THE 1992 Ao ni da ca 3 mau tron,200000,119000,4.5,2,2
63750,15,Ao So Mi Dai Tay Caro Vai Bamboo Form Regular Vinh Tien 425,425000,361250,5,2,3
0,0,Ao Vest thoi trang nam,299000,299000,4.6,5,11
25800,20,Quan lot nam Hunk Bikini Ho suon Uc H05 - Trang,129000,103200,4.3,16,96
0,0,"Ao so mi FLANNEL ke caro Unisex phong cach streetswear, Ke Caro Nam Nu Form rong Phong Cach, Ao So Mi Khoac Ngoai Cao Cap Sieu Dep, Ao khoac sowmi unisex form rong CARO nam nu phong cach ulzzang",95000,95000,4.3,6,20
0,0,"<HOT> Ao khoac du bomber nam nu unisex form rong vai 2 lop chat xin, day dan, y anh phong cach han quoc (bida)",95000,95000,0,0,2
0,0,Bo vest nam 6 cuc Han Quoc cuc sang trong - DUKI STORE,699000,699000,4.5,2,3
150000,25,Quan Kaki Nam Trung Nien Khong Ly Hoa Tiet Chim Cao Cap 9008 Viet Phap,609000,459000,5,1,1
0,0,"Ao khoac One Piece Zoro K01, Ao khoac hoodie Anime Manga One Piece Roronoa Zoro Unisex Nam Nu",220000,220000,4.6,9,15
0,0,Ao Thun Nam Co Polo Hoa Tiet KO888 Cao Cap,125000,125000,4.2,18,53
0,0,AO KHOAC DU NAM FORM RONG 2 LOP ,67000,67000,5,1,2
0,0,Ao So Mi Nam Tay Ngan Hoa Tiet The Shirts Studio Han Quoc TD42F2315BL,89000,89000,4,1,5
0,0,Ao So Mi Nam Ngan Tay Phoi Tui Mau HR511 Thoi Trang Nam Cong So Ca Tinh,130000,130000,5,1,5
0,0,Ao Thun Nam Phoi Chu NY222  Chat Thun Mem Min Thoang Mat Tham Hut Mo Hoi Tot,125000,125000,5,1,2
0,0,Ao thun tay lo form rong hoa tiet nhan vat hoat hinh Tomm - Unisex nam nu deu mac duoc,79000,79000,5,1,2
0,0,Quan Short Kaki Tui Hop Danh Cho Phai Manh,150000,150000,4.5,21,93
50000,22,"Ao dui nam co bo tru 5 khuy tay coc, thoi trang tre, phong cach Han",229000,179000,4.5,2,2
50000,23,"Ao so mi nam trang Amazing, vat bau, dong phuc hoc sinh, cong so, form suong Regular, chat lieu KT silk mem muot, size tu 45-105kg",219000,169000,5,2,10
50000,25,"Ao Polo nam co be ngan tay, chat lieu vai ca sau cotton cao cap, tre trung, nang dong – FORMEN SHOP – FMPS111",199000,149000,4,2,2
40000,21,"Ao Polo nam co be ngan tay, chat lieu vai ca sau cotton cao cap, tre trung, nang dong – FORMEN SHOP – FMPS114",189000,149000,4.3,16,31
209000,50,Bo Ni The Thao 4 Mau Thiet Ke Nang Dong Tre Trung Cao Cap ZERO,418000,209000,4.7,3,14
14000,20,QUAN LOT NAM QSHOP QB891,70000,56000,5,2,28
0,0,"Ao Phong Nam Cao Cap,Sieu Dep M.O.N Boutique MONEO01",125000,125000,3.8,5,10
0,0,ao thun dai tay nam trung nien ao cho bo nhieu mau,160050,160050,5,6,20
0,0,Ao Thun Tron Nam - Nu Unisex,39999,39999,4,9,26
0,0,"Zakado Outlet - Ao thun cao cap co tron, tay ngan .",180000,180000,5,2,2
0,0,"Ao Hoodie Ni - Ao Khoac Ni Nam Nu Unisex Ni BECHY 4 Mau Cuc Hot, AO HOODIE GAU BECHY, AO HOODIE UNISEX NAM NU DAU MAC DUOC, AO HOOIDE TAY PHONG ULZZANG, ao hoodie tranh mua, chong nang",94000,94000,5,3,7
50000,42,QUAN  DUI BOXER NGU NAM FEZZIO SPORT CHINH HANG,119000,69000,4.8,5,9
0,0,Ao Khoac Nam The Cosmo HUDSON PARKA 2 mau TC1023064R2,769000,769000,5,1,2
0,0,Combo 5 quan sip dui Muji nam Thong hoi,120000,120000,5,3,8
0,0,Ao Thun Nam Sat Nach PERVIC,99000,99000,4,17,452
55000,50,"Quan Sip Dui Nam 5S (4 mau), Cap Det Khong Duong May, Tham Hut, Co Gian, Khang Khuan Cuc Tot (SIP21010BOX)",110000,55000,5,1,6
0,0,QUAN TAY NAM TRUNG NIEN,102700,102700,4.1,8,22
0,0,AO BA LO NAM VAI MEM MIN KHONG XU LONG,42900,42900,4.2,13,18
0,0,Bo quan ao thu dong nam vai ni big size danh cho nguoi beo nguoi map,550000,550000,4.5,2,7
58400,46,"Quan Coc Nam Chat the thao co gian,Tre Trung Nang Dong Khaviman QC01",127400,69000,2.5,2,6
0,0,Ao thun nam ngan tay co tron Santino chat lieu cotton dang xuong thoai mai TRT265T900,265000,265000,5,4,7
10000,5,Ao Khoac Chui Dau Free Fire Mau Moi,200000,190000,4.2,61,436
0,0,Ao So Mi Nam 9 Mau So Mi Nam Cao Cap Theu Huy Hieu,115000,115000,1,1,1
0,0,Quan nam MIKENCO Side printed short,450000,450000,5,2,2
0,0,Ao T-Shirt unisex MIKENCO PSYCHEDELIC EFFECT,750000,750000,5,1,1
0,0,Ao T-Shirt unisex MIKENCO Couture - Den,500000,500000,5,1,1
0,0,Ao T-Shirt unisex MIKENCO Mona lisa AR,900000,900000,5,2,4
0,0,Ao T-Shirt unisex MIKENCO Mona lisa AR Trang,900000,900000,5,1,1
0,0,Ao phong nam MIKENCO Label tag tshirt,650000,650000,5,1,1
0,0,Ao vest nam phong cach Han Quoc nhieu mau,158000,158000,3,6,10
0,0,"Ao khoac du nam nu mac ,ao khoac gio , ao khoac vai du loang mau cao cap 2 lop",126000,126000,2,1,
0,0,AO KHOAC KAKI NAM TRON MAU MOI 3 MAU VAI KAKI,238000,238000,1,1,5
0,0,"Ao So Mi Nam Vai Nen Lua Mau Trang , Den , Xanh Than , Xanh Lam , Xanh Da Troi",99000,99000,3.7,3,7
0,0,Ao Khoac Du Nam Co Non,70000,70000,0,0,1
0,0,Ao Khoac Du Nam 2 Mat Cuc Hot,76000,76000,5,2,8
0,0,AO BA LO NAM CHAT THUN LANH THE THAO CO GIAN 4 CHIEU,139000,139000,0,0,
0,0,Ao Khoac Du Sevenzia Bomber Unisex Nam Nu cuc dep thoi trang kim gia,94000,94000,1,1,2
0,0,ao khoac ni nam nu cuc duyen phong cach tre trung nang dong viet moi,95000,95000,0,0,
0,0,AO KHOAC BOMBER CAO CAP,399000,399000,4.5,4,8
0,0,Quan jean nam 10,99000,99000,2.8,6,34
0,0,"Quan the thao nam nu, quan jogger ong suong 3 soc 1 soc chat day dan, vai cao cap Joger",79000,79000,0,0,2
0,0,Ao so mi nam tay dai soc den to trang ,90000,90000,3.7,29,104
0,0,AO KHOAC DA NAM LOT LONG,278000,278000,5,1,
1000,1,Ao thun bong ro NBA Chicago Bull  chat vai me Thai thoang mat,99000,98000,4,1,4
0,0,Ao Thun Co Co Nam Giordano Lion 3D Polo 01010222,640000,640000,4.5,2,2
111200,44,"Quan short jeans nam , quan sort nam eo co dan tron lich lam mau J73 san lai thiet ke phong cach thoi thuong loi cuon dao pho Julido thoi trang han quoc trung nien",250200,139000,5,10,25
127200,44,"Quan jean nam chat jean xin Julido, Phoi rach mau moi form dep ton dang khong qua om mau Top04",286200,159000,4.2,84,180
0,0,Quan Sot Nam Rach ️️ Quan Short Jean Nam Chat Bo co gian thoi trang Han Quoc form cuc dep To To Shop -QSJNM229,149000,149000,3,2,3
0,0,AO KHOAC NAM  HAI LOP FLY XU HUONG HAN QUOC SIEU  DEP,159000,159000,4.2,114,1650
0,0,"Ao thun Polo nam co tru chat lieu vai cotton xuat xin tre trung don gian ,phong cach hien dai",159000,159000,5,1,2
0,0,Ao khoac phao long vu nam chong nuoc chong gio chong lanh ,460000,460000,3,1,7
0,0,SET 2 CHIEC SIP DUI NAM NHAT THUN LANH THOANG MAT,115700,115700,4,1,3
0,0,Quan Nam Basic Tron Mau Bo Gau Phong Cach Tre Trung Thoi Trang Zenkonu QUAN NAM 1000087,79000,79000,1.5,2,10
0,0,Bo Quan Ao Nam Áo Thun In Chu NASA Quan Short Soc In Chu Ulzzang Thoi Trang Zenkonu SHORT NAM 1000029 + TOP NAM 1000178,79000,79000,2,1,4
0,0,Quan Short Nam Phoi Tui Nap Hop Tron Mau Basic Ca Tinh Kieu Dang Tre Trung Thoi Trang Zenkonu SHORT NAM 1000026,62100,62100,1,1,3
0,0,Ao so mi nam hoa tiet bat mat trang den,185000,185000,1,1,
0,0,AO KHOAC KAKI NAM GIA VEST DEP,235000,235000,5,1,1
0,0,Ao khoac da nam bomber xin xo ,178000,178000,0,0,
0,0,Ao so mi nam tay dai hoa tiet rong vien khuyu tay,175000,175000,1,1,1
0,0,Bọ Dò Di Chùa Cho Nam - La Hán Lam,194000,194000,0,0,1
0,0,AO SO MIA LUA NAM NU CO SO MI CUC DEP CUON HUT SIEU PHAM HOT NHAT NAM,89000,89000,2.7,3,19
0,0,AO KHOAC KAKI NAM 1 LOP MIN KIEU KHOAC FROM RONG PHONG CACH HOA NAM THAN CUC NGAU BAO DEP,140000,140000,4.5,2,5
144000,44,"Ao Khoac Nam Nu cao cap Julido Store, thoi trang Unisex mau moi NK02",324000,180000,4.8,25,44
0,0,QUAN NI NAM DAI CUC DEP PHONG CACH MOI LA,65000,65000,1,1,1
0,0,"AO HOODIE NON NAM NU MAU DEN VAI NI POLY IN SUNG NUOC Unisex hoodie,Ao Khoac Ni Hoodie In Datlity, Ao Khoac Ni Hoodie Unisex Nam Nu Cao Cap",110000,110000,5,1,3
0,0,AO HOODIE NAM NU PHOI THUN CAO CAP THOI TRANG TEEN TP,136300,136300,5,1,2
0,0,Ao khoac gio,96000,96000,1,1,1
50000,34,Ao Thun The Thao Nam TSIMPLE co tron tay ngan tap gym vai thun lanh thoang mat co gian chuan form MSSAHRBC,149000,99000,5,2,16
0,0,Ao khoac jean nam rach cao cap vai jean denim khong nong hang chuan shop Phuongnamshop20 rkv23,160000,160000,4.7,3,1
0,0, - AO THUN TAY NGAN DREW UNISEX DU SIZE XS S M L XL XXL,32500,32500,5,2,4
144000,44,"Quan Short Jean Nam co dan kieu dang tre trung don gian Thuong Hieu Chandi, quan sot mau moi xu huong 2021 QSJN223",324000,180000,5,9,21
0,0,Ao khoac kaki NAM FORM RONG CUC CHAT SIEU PHONG CACH THOI TRANG ,145000,145000,0,0,1
0,0,Ao doan thanh nien viet nam dai tay chat dep,90000,90000,3.8,4,20
0,0,Bo Quan Ao Nam Ao Thun Nam Tay Lo In Hinh Meo TOM Quan In Chu Phoi Day zenkonu TOP NAM 1000154 + SHORT NAM 1000010,79000,79000,5,1,3
0,0,Set Do Lam Di Chua Cao Cap Cho Nam s1,181090,181090,5,2,6
0,0,Do Lam Di Chua # Ao Trang # Ao Khoac # Nam Nu,85000,85000,5,1,6
0,0,Quan kaki ong con nam chat kaki mem,68900,68900,4.3,4,8
0,0,Ao so mi nam hoa tiet do 425,199000,199000,5,1,10
0,0,INSANE Basic Hoodie Zip ver 1.0 - mau Mo Ga,448500,448500,5,1,1
0,0,QUAN JOGGER KAKI NAM NU,189000,189000,4.7,3,4
0,0,Ao hoodie dang rong phong cach Han Quoc tre trung cho cap doi(ma M4),145000,145000,5,1,4
0,0,"Ao So Mi Nam Dai Tay Co Tau - Co Tru Chat Dui Cao Cap, Phong Cach Thoi Thuong ( SP3)",168000,168000,5,1,3
0,0,Ao so mi nam viet tien mau trang dai tay chat lieu Bamboo soi tre,500000,500000,5,2,8
185000,21,Quan Jeans Dai Nam Giordano Jeans 0111906383,890000,705000,5,1,2
0,0,Ao khoac phao nam nu long vu mua dong form han quoc sieu nhe day dan giu nhiet tot,329000,329000,5,1,
0,0,"Ao so mi nam ngan tay May 10, it nhan nhau, chat Spun dep co gian",199000,199000,4.7,3,22
98000,49," AO CHONG NANG NAM DAP VAN CA TINH, KHANG DINH DANG CAP PHAI MANH",200000,102000,4,1,2
0,0,ÁO THUN POLO NAM LEVI'S  35883-0013,699000,699000,5,1,1
130000,37,"Ao So Mi Nam Ngan Tay  Hoa Tiet ( 4SMCH010TRT) Phom  Bodyfit  Tre Trung,Thanh Lich, Vai Nano Cao Cap Thoang Mat,Mem Min ,Khong Nhan Xu,Hang Chinh Hang Biman by Biluxury",349000,219000,4,1,4
284000,50,OWEN - Ao so mi dai tay Owen Slimfit chat modan mau tim 80761,568000,284000,4.3,4,7
0,0,AO THUN POLO NAM LEVI'S SS REGULAR 22401-0002,699000,699000,5,1,2
150000,50,Ao Phong Nam Polo Co Co Ngan Tay Thoi Trang ZERO  Han Quoc,300000,150000,5,1,2
150000,50,Ao Thun Nam Polo Co Co Tay Ngan Cao Cap BATINO 6 Mau Han Quoc,300000,150000,4.5,4,12
60000,43,Quan tay nam ong suong trung nien vai cotton 2 da day form thoai mai loai quan ong suong tay QT2,139000,79000,5,1,1
15000,21,Quàn dùi nam Cotton mạc nhà thoải mái thoáng mát JAMANO- 1 Chiéc MÀU NGÃU NHIEN,70000,55000,4.5,2,35
0,0,Ao so mi nam dai tay mau tim,149000,149000,5,1,2
86000,37,Ao Khoac Big Size Ao Khoac Du Day Nam Lot Ni Chong Lanh Chong Nang Chong Gio Han Quoc Cao Cap QD64 - ShopN6 (Nhieu Mau),235000,149000,4.5,8,15
0,0,"AO KHOAC KAKI TUI HOP NAM , AO KHOAC KAKI NAM , AO KAKI NAM , AO KHOAC NAM FORM RONG",118000,118000,0,0,
0,0,Combo 3 Quan Sip Duc Cao Cap Nhat Ban (Mau ngau nhien),138900,138900,4.6,175,2061
0,0,QUAN TAY NAM TRUNG NIEN VAI DAY BEN SIZE 50-85KG,99000,99000,4.5,21,60
1300000,65,QUÀN JEANS NAM DAI LEVI'S 501 STRAIGHT 80746-0001,1999000,699000,5,3,5
110000,39,"Ao Thun Nam Giu Nhiet (ATOH021)  Phom Slimfit Sieu Nhe Khong Bai Xu ,Hang Cao Cap Chinh Hang Biluxury, Giao Mau Ngau Nhien",279000,169000,4,2,4
0,0,Blentino ao so mi dai tay cong so ke BSM08(2),585000,585000,5,1,1
0,0,Quan Au Nam Slim - Thuong Hieu Blentino - BL - DD 29593-05,485000,485000,4,7,8
0,0,Ao cardigan nam mau tron kieu dang Han Quoc - AC-B01-1,251900,251900,5,1,5
372000,50,"Quan Boi Nam Speedo Boomstar 16"" Watershort - 8-12432D861",745000,373000,5,1,1
0,0,Ao thun nam polo tron trung nien vai cotton mac MAT form rong thoai mai ao thun nam soc co soc tay,79000,79000,4.3,18,25
0,0,COMBO 4 QUAN LOT NAM BOXER CAO CAP,220000,220000,0,0,
0,0,Ao so mi nam ngan tay mau xanh bien,98000,98000,3.8,4,13
0,0,"AO THUN NAM 3 LO ( MAU VANG , TRANG , DEN VA XAM ) ( VIDEO HINH THAT )",67000,67000,3,1,2
0,0,Ao So Mi Nam Cach dieu Nhieu mau LV741,159000,159000,4.5,7,12
0,0,Ao so mi nam soc trang xanh ,149000,149000,3.7,3,7
0,0,"Quan Jogger nam Kaki loai dep, quan nam gia re QN006",83000,83000,5,1,1
91000,27,Combo 4 Quan Sip Nam Quan Lot Nam Soi Cotton Cao Cap MRM FASHION Mix 2 Mau TANG Doi Tat Nam Cao Cap,340000,249000,4.8,8,35
150000,30,Ao thun nam Ellesse Lentamente - 619305,500000,350000,3,1,1
0,0,Ao polo nam trung nien soc ngang vai thun mat loai ao thun nam ngan tay co co fom rong rai ATSG60,99000,99000,3,2,13
49000,50,Ao Ba Lo Nam Vai Bong Cotton The Thao Tham Hut Mo Hoi Thoang Mat ABL01,98000,49000,1,1,4
0,0,"Ao So Mi Nam Ngan Tay Co Tui Mau Be Tron (4SMCB005BEV),Phom  Bodyfit  Tre Trung,Thanh Lich, Chat Vai Cao Cap Thoang Mat,Mem Min Hang Chinh Hang BILUXURY",465000,465000,0,0,
0,0,Ao so mi nam tay dai hoa tiet Santino chat lieu soi tre chong tia UV dang lim sang trong ASD525S593,472500,472500,4,1,2
0,0,Ao somi dai tay nam D3123J1206 GENVIET,468000,468000,5,1,1
237600,45,Quan Tay Nam Khatoco Khong Ply Ong Om xanh duong dam KHATOCO Q1M528S0-CNMA005-2007-0,528000,290400,4.6,93,213
101000,0,Ao so mi nam dai tay soc caro cong so xuat khau co tui CAO CAP loai ao so mi tay dai cao cap dong hop ASHD30,0,99000,3.2,5,
0,0,Quan Tay Nam Hoa Tiet BILUXURY 4QAUH001TTS,545000,545000,4.8,6,8
0,0,Combo 3 quan lot nam tam giac cotton thong hoi mac mat thoai mai loai quan sip nam tam giac (giao mau ngau nhien),49000,49000,4,1,5
0,0,"Quan Tay Cong So Nam BLENTINO DD29593-7 Co Gian, Chong Nhan, Khong Phai Mau",485000,485000,4,3,14
165000,47,Áo Hoodie 7 Mau Tron Thiet Ke Nang Dong Thoi Trang Cao Cáp VICERO,350000,185000,1,1,8
0,0,Ao so mi nam co tru chui dau dai tay ke soc trang den,149000,149000,4.7,6,16
50000,20,Ao Khoac Kaki Jean Wash Nam Nu Unisex Co Co Be Chong Lanh Chong Nang Chong Gio Chong Tia Uv Day 2 Lop Thoi Trang Han Quoc Cao Cap KK52 - ShopN6,245000,195000,3.8,6,9
0,0,AO KHOAC NAM NI NGOAI LOT LONG ,169000,169000,3.7,3,11
0,0, Quan Baggy Nam - Quan Jean Nam Mau Xam Rach Goi - Hotboy han quoc jean wash day,175000,175000,0,0,
0,0, Quan Lot Nam Quan Sip Dui Nam Cotton Co Gian Bon Chieu Thoang Mat Khang Khuan Form Om Tinh Te,31200,31200,0,0,1
0,0,AO KHOAC NI HOODIES HOA TIET CUTE,69000,69000,4.5,2,2
0,0,Ao thun nam co co ca sau vai loai tot nhap tu loai ao thun tay lo size 55kg den 85kg,79000,79000,3.4,22,52
190000,35,Ao So Mi Nam Cong So Tay Dai Cao Cap AKUBA | 02A918,549000,359000,4.5,4,11
71000,47,"Quan Short Nam Chat Cotton Thoang Mat,Quan Dui Nam 4 soc Kieu Dang The Thao Nang Dong",150000,79000,4.1,14,33
41000,32,Ao Tap Gym 3 Lo Nam Tanktop Thun Lanh Co Gian 4C Tham Hut Mo Hoi,130000,89000,4,10,31
156000,60,"Ao thun nam in phoi co GUMAC in chu nang dong, lich lam nhieu mau ATNB474",260000,104000,4.3,17,28
105000,28,"ComBo 2 ao thun nam ao thun tron Cao Cap MRM FASHION( ( Den,Ghi)",370000,265000,5,3,8
126000,43,Combo 5 quan lot nam 5 mau 2 bang lung - Vai thun lanh cuc mat.,295000,169000,3.9,8,26
0,0,Combo 3 quan ship dui nam thun lanh khong han mong STLKH09,76988,76988,4.5,15,43
0,0,Blentino Quan Short Gio Nam BQTT-01,195000,195000,3.9,20,52
7000,7,Ao so mi nam trung nien tay ngan vai dui min SIEU MAT form rong rai thoai mai SMDOG60,99000,92000,4,4,16
0,0,"AO THUN NAM , AO THUN FORM RONG , AO NAM , AO THUN TAY LO FORM RONG PHOI TAY VA TUI",60000,60000,5,1,5
0,0,Ao so mi nam dai tay mau den ,69000,69000,3.8,9,17
0,0,Bo ni nam thu dong thoi trang STYLE MARVEN hoodie in chu phoi jogger bo gau nang dong - SET NAM 9000076,119000,119000,4,1,1
70000,25,Combo 3 Quan Sip Nam Quan Lot Dui Nam Boxer Soi Cotton Cao Cap MRM FASHION 1 mau TANG Doi Tat Nam Cao Cap,285000,215000,4.5,13,21
0,0,Quan baggy nam - Quan au Skinny,180000,180000,4,1,11
0,0,Blentino Ao polo nam PL015,395000,395000,5,1,3
0,0,Ao so mi nam co tau dai tay chat vai cotton day mem min co gian tot kieu dang slimfit mac vua van co size tu 50kg-75kg,69000,69000,4.2,6,15
0,0,Quan Ni Jogger Ong Suong - Quan Thun Dai The Thao Hoa Tiet Hoat Hinh Ulzzang Nam Nu Unisex - AO KHOAC THIEN HA,93000,93000,4,1,1
92000,39,Ao Khoac Big Size Ao Khoac Du Day Bomber Nam Nu Chong Nang Chong Lanh Chong Gio Lot Ni Hai Lop Han Quoc Cao Cap QD66 - ShopN6 ,235000,143000,4.5,30,59
0,0,Ao thun nam za ra ngan tay vai xin dep mat nam nu deu mac duoc size tu 40kg den 65kg,55200,55200,4.3,23,31
0,0,Ao Thun Unisex Nam Nu Form Rong SDVN Donut Worry,150000,150000,5,1,1
85000,35,Ao Khoac Du Nam Hai Lop Co Tru Vien Cao Cap ADS27,240000,155000,4.7,27,97
210600,45,Quan Kaki Nam Khatoco Q2M468R1-VNMA011-1811-1 - Nau,468000,257400,4.5,30,126
76000,34,Ao Khoac Nam Ao Khoac Du Day Nam Hai Lop Lot Ni Chong Lanh Chong Gio Chong Nang Tia UV Cao Cap AD64 - ShopN6 (Nhieu Mau) ,225000,149000,4.2,10,18
0,0,"Blentino Quan Lot Nam Boxer Blentino D03, Chong Khuan,Tham Hut Mo Hoi.",85000,85000,3.5,2,3
0,0,Quan tay nam trung nien cao cap mem min quan tay cong so size 45kg-70kg,245700,245700,5,2,3
0,0,BO QUAN AO THE THAO BO DO MAC NHAD THOI TRANG NAM NU,75000,75000,3.7,3,7
11000,10,Ao Thun Nam Co Co Mau Tron Phom Body Ao Thun Ca Sau Cotton 4 Chieu Thoi Trang Han Quoc Nam Tinh Gia Tot Cao Cap AT11 - ShopN6,110000,99000,3.8,6,12
0,0, AO SO MI IN NGOI SAO,100000,100000,5,1,1
119000,50,Quan Dui Nam The Thao Ni Bong Thoi Trang Phong Cach ZERO,238000,119000,5,3,12
0,0,AO THUN NAM TAY LO FORM RONG IN MAC NGUOI,52000,52000,5,1,1
0,0,Quan Lot Duc Nam Lua Sua Cao Cap,38000,38000,4.3,3,3
0,0,Combo 5 quan sip cheo nam Munafie co gian 4 chieu,63900,63900,5,1,
173000,51,Bo Mac Nha The  Thao Nam Mua He Thun Mong Cao Cap ZERO - BTT18 XANH THAN - M,338000,165000,0,0,4
0,0,Quan tay nam trung nien chat vai day mem min khong nhan khong ra mau,114000,114000,3.6,5,11
0,0,Áo Thun Unisex Nam Nũ SDVN Pastel,150000,150000,5,1,1
0,0,QUAN KAKI NAM TUI HOP CO DAY KEO SIZE M L XL,78000,78000,0,0,
0,0,Blentino Quan lot nam boxer chun ban lon. Vai cotton tu nhien co gian tot Blentino D05,85000,85000,5,2,6
500000,33,ÁO KHOÁC HOODIE NAM LEVI'S RELAXED 38821-0010,1499000,999000,5,1,
0,0,Blentino Ao thun Nam Polo cao cap BL-PL27,355000,355000,4.5,114,234
3600,3,Hop 5 Quan Lot Dui Nam Thong Hoi Xuat Nhat,120000,116400,0,0,1
0,0,Ao Co Lo Nam TA13,69000,69000,0,0,
0,0,Ao khoac phao nam co mu thoi trang han quoc 3 lop vai cao cap chong nuoc khong bam ban giu nhiet mua dong duoc nhap boi cong ty Xuan Anh,440000,440000,2,1,2
0,0,Ao Len Nam nhieu  Mau co ba phan Tron Phong Cach Tre Trung Lich Lam duoc nhap khau boi cong ty XUAN ANH,199000,199000,0,0,2
0,0,[hang dep- mat min-khang khuan] 05 sip tam giac thong hoi hang xuat co gian 4 chieu om gon khong han da,86000,86000,0,0,
178000,30,Ao thun the thao nam New Balance - MT11909WT,595000,417000,3,1,3
0,0,"Ao ni Hoodie LASHI shop , ao ni bong hoodie unisex nam nu, han quoc Cao Cap Freesize",59000,59000,0,0,
0,0,"Ao so mi nam tay ngan hoa tiet hoa AKUBA form regular, chat lieu mango vai nhe, mat, tham hut tot 01AB2104",549000,549000,5,1,6
0,0,Ao so mi nam dai tay co tau,142800,142800,0,0,1
79200,44,"Ao thun nam the thao tay lo, co tron dep, tre trung, mac thoang mat, tham hut tot CHANDI HH12",178200,99000,4.6,12,49
4050,3,COMBO HOP 5 Quan Lot DUI Nam Xuat Nhat Cao Cap (MIX NGAU NHIEN),135000,130950,0,0,
0,0,"Ao Khoac Nam Chat Gio Pmax (3 mau), Co 2 Lop, Co Mu, Dang Tre Trung, Chong Tham Nuoc, Chong Gio, Thich Hop Nam Nu",169000,169000,4.8,15,21
91000,46,"Quan Au Nam KOJIBA Chat Lieu Cao Cap, Phong Cach Tre Trung - Mau Xam (Ghi Xam)",200000,109000,4.1,13,123
0,0, Hop 4 quan sip tam giac nam Nhat,52000,52000,0,0,3
80000,37,Quan Jogger Nam Nu The Thao 3 Soc 2in1 Chat Ni Da Ca Cao Cap Form Quan Suong Bo Gau E'mer Mau Moi Nhat,219000,139000,2.8,6,17
0,0,"AO THUN NAM TAY LO FROM RONG,THIET KE HOA TIET SIEU NGAU",55000,55000,5,3,11
0,0,"Ao so mi nam dai tay cao cap : Chat lieu lua , khong nhan, khong xu , thoang mat, tham hut mo hoi",135000,135000,5,2,5
0,0,Bo quan ao giu nhiet nam chat ni tran bong,260000,260000,3.5,4,15
0,0,"Ao so mi nam Xam Ke khong nhan, So mi nam chat pha Dui dep",108000,108000,5,1,7
0,0,"Ao hoodie nam vai ni bong, form rong phong cach Unisex HD06",149000,149000,5,1,2
0,0,COMBO 5 QUAN TAM GIAC NAM DET KIM TRON MUNAFIE 8052,125000,125000,4.7,3,12
55000,37,"Quan Ao The Thao, Set Bo The Thao Nam DINKBHAYS, Bo Do The Thao Nam Chat Dep, Do bo the thao nam, set quan ao the thao nam nu mac nha Unisex tay ngan phong cach Ulzzang, Set Bo Quan Ao The Thao Nam Mua he Co Dan, SET DO BO THE THAO MAC NHA, do bo mac nha dao pho",150000,95000,4.8,28,74
0,0,Ao Thun Nam Phan Quang 7  Mau Hang De Vo,60000,60000,4.5,44,102
0,0,"Ao Thun Nam Phan Quang The Witcher, Ao Uninsex, Tay Ngan, Co Tron, Co Ao Thun Size Lon 2XL, 3XL, 4XL, XXL, XXXL, XXXXL",60000,60000,5,12,25
0,0,Quan Lot Nam Boxer- Sip Dui Thun Lanh Giam Nhiet Mong Mat K170,35000,35000,5,1,11
0,0,Ao Khoac Jean Nam-Ao Khoac Rin Chat Bo Cao Cap GH209,189000,189000,1,1,2
0,0,Bo Quan Ao Ni Nam Lot Long Sieu Am Cao Cap QB1,245000,245000,3.7,20,40
0,0,Ao boi tay dai chong nang TYR Long Sleeve Rashguard,750000,750000,4,3,10
190000,35,Ao So Mi Nam Cong So Tay Dai Hoa Tiet Soc AKUBA | 02A919,549000,359000,4.5,2,3
44000,20,[ Co anh that ] Ao so mi unisex form rong - somi nam nu soc so 13,223000,179000,4,4,5
153000,34,Quan Short Jean Nam Thoi Trang AKUBA Form Skinny | 01D19128,449000,296000,5,1,2
0,0,"Set 3 Ao Thun Nam 3 Lo, Ao Tap Gym,The Thao, Soi Cotton Mem Min, Co Gian Tham Hut Mo Hoi Tot, Thoang Mat",65000,65000,3.8,4,12
0,0,"Ao khoac phao beo sieu nhe Santino mu chum chat lieu giu nhiet, chong tham nuoc phom dang vua van 01",685000,685000,3.7,3,8
16000,50,Ao thun nam in 3d sieu chat - Ao phong nam phong cach gia cuc re | Shop T-Shirt,32000,16000,5,1,1
0,0,"Quan jogger nam kaki dang om body tre trung, ong bo chun nang dong, khong xu khi giat may, mac da ngoai, size tu 45-76kg, nhieu ma lua chon",39000,39000,0,0,8
0,0,Quan jogger the thao nam kaki ma TT54 kieu bo ong Han Quoc chat vai dep ong dai,79000,79000,0,0,
0,0,QUAN SHORT JEAN NAM THOI TRANG  BM107,94000,94000,5,2,9
3600,3,Combo 5 Quan Lot Nam Tam Giac Nhat,120000,116400,0,0,
0,0,Quan Bo Nam Trang Rach Goi TRANGRACH02,144000,144000,4.8,5,16
10000,10,Quan lot nam thun boxer Espresso iBasic PANM103,99000,89000,4,2,12
50000,25,Quan lot nam cotton dui dai iBasic PANM083,199000,149000,5,1,3
40000,25,Quan lot nam thun lanh boxer iBasic PANM085,159000,119000,4.5,2,5
0,0,Quan Jeans Nam Ong Suong Wachs Ben dep,129000,129000,3.5,2,6
0,0,"Quan jogger kaki nam tui hop nhieu tui day khoa gai mau den, phong cach duong pho JNEAS",79000,79000,1,1,1
24000,20,[ Co Anh That ] Ao thun tay dai form rong unisex - Sweater Luffy,123000,99000,5,2,2
0,0,Quan jogger nam tron bo gau thun ni,59000,59000,0,0,
0,0,QUAN LOT NAM SU DUC DANG DUI HANG XUAT SIEU DEP-NEW,71900,71900,5,2,4
0,0,Hop 5 cai quan lot tam giac thong hoi nam - Sip luoi nam thoang mat,90900,90900,4,1,6
0,0,"Quan short kaki nam tui hop cao cap quan bo nam vai kaki day dan loai tot khong xu long, khong bay mau",141250,141250,1,1,8
0,0,Ao Khoac Du Toriondy Nam Nu CapHOT RE DEPAo Gio Chong Nang Unisex Rong Black Miack Kieu bomber Bong Chay Couple Jakets [ ANH THAT ] - HIEN LINH UY TIN SHOP AO KHOAC BOMBER DU GIO,95000,95000,4,2,4
100000,30,Ao so mi nam dai tay LADOS - 18024 - VAI OXFORD CUC CHUAN form dep,329000,229000,5,1,12
0,0,QUAN JEAN NAM RACH THOI TRANG  QJ019,99000,99000,3.8,4,9
0,0,Quan short jean nam cao cap vai COTTON 100% hang dep chuan form rong loai quan bo nam cotton dep,99000,99000,5,2,8
0,0,Quan jean nam KL1028,137000,137000,3.7,23,43
0,0,Quan jean Nam den ,99000,99000,4.5,13,33
0,0,Quan jean nam HSS46,99000,99000,3.5,2,5
0,0,Quan Jean nam ong dung️️ thoi trang duong pho cao cap phong cach Han Quoc K2011,311000,311000,5,1,5
0,0,"Quan au, quan tay nam Quang Chau, phong cach Vintage Han Quoc C001",259000,259000,5,4,8
0,0,"Quan jean dang suong rong, quan bo baggy tron form ong rong nam de phoi do, chat jean dep",179000,179000,5,1,
0,0,"Ao hoodie, ao sweater tron nam nu",95000,95000,4.5,19,39
159000,20,"Bo nam thu dong cao cap Narsis E8016 ni xanh ke den  tre trung nang dong, chat lieu  cao cap cuc mem mai thong thoang",795000,636000,4,2,1
0,0,Quan Short Teelab Prenium Basic PS006,195000,195000,5,1,1
146250,45,Ao Nam Narsis D4120,325000,178750,4.5,2,9
111000,20,"Bo nam thu dong cao cap Narsis E9004 mau xanh  tre trung nang dong, chat lieu  cao cap cuc mem mai thong thoang",555000,444000,5,1,5
111000,20,"Bo nam thu dong cao cap Narsis E9005 mau tim than  tre trung nang dong, chat lieu  cao cap cuc mem mai thong thoang",555000,444000,5,2,4
222750,45,"Ao khoac nam Narsis D6074 mau sac tre trung nang dong, chat lieu Cotton len cao cap cuc mem mai am ap, san pham duoc san xuat tai Viet Nam boi thuong hieu thoi trang noi tieng NARSIS",495000,272250,5,2,3
65000,20,Ao so mi nam coc tay Narsis D0008,325000,260000,4.7,3,3
0,0,DÒ LAM DI CHÙA CAO CÁP CHO PHAT TU NAM S2,239000,239000,1,1,1
0,0,"Combo 5 Quan Boxer Nam Det Kim (freesize 50-85kg), Quan Sip Dui Nam Ma D01",130000,130000,4.8,6,36
49200,41,"Ao thun unisex ao thun nam form rong tay lo , áo thun nam cổ tròn tay ngan ao thun unisex in Cau vong Hiperst",120000,70800,5,1,1
57400,41,"Ao thun nam tay dai co lo ao thun nam form rong tay lo , áo thun nam cổ lo tay ngan ao thun unisex",140000,82600,4,1,2
102090,41,Áo thun nam Ngán Tay in Họa Tiét Phong Cách CHu Meo trong Lon mau trang thun cotton 100% The Ngau Style,249000,146910,4.8,4,24
63960,41,Ao thun Stee nam tay lo unisex form rong overtee La Phong Han Quoc mau trang va den chat vai cotton xin Trumunisex,156000,92040,4.3,3,3
63960,41,Ao thun Stee nam tay lo unisex form rong overtee in da quang phan quang 7 mau Slime magic chat vai cotton xin Trumunisex,156000,92040,5,1,1
102090,41,Ao Thun Nam Tay Lo Unisex co Tron chat lieu vai cotton mau trang form rong in chu MUST quanh co phong cach doc chat TheNgaustyle,249000,146910,4.8,4,10
58500,39,Ao thun Stee V FRIENDS Unisex trumunisex aothununisex,150000,91500,5,1,
0,0,Quan Jean Nam Cao Cap,99000,99000,4.6,43,120
0,0,"Ao khoac du , ao khoac gio  nam nu mac , ao khoac nam nu mac vai du 2 lop size L va XL",98000,98000,4.7,53,123
69290,41,Ao thun Stee nam tay lo unisex form rong overtee Cat beo  nhieu mau chat vai cotton xin Trumunisex,169000,99710,4,1,1
102090,41,Ao Thun Nam Tay Lo Unisex co Tron chat lieu vai cotton mau den form rong in chu NAREY quanh co phong cach doc chat TheNgaustyle,249000,146910,5,1,1
284000,28,AO NI MU NAM OVERSIZED LONG CUN,999000,715000,5,1,
149000,50,Tee- Ao thun MA Basic Regular tui nguc,299000,150000,5,8,10
0,0,"Ao so mi trang dai tay ARISTINO voi thanh phan 100% Micro Polyester cho be mat tron bong, mem mai, it bam bui, dang Slim fit gon gang lich su ALSR18",695000,695000,5,1,1
40000,5,AO NI MU TET HD O BOO X MAITHU,799000,759000,4.6,11,14
112050,45,Ao Thun Nam Tay Lo Unisex co Tron chat lieu vai cotton mau den form rong in chu Enternity phong cach doc chat NS074,249000,136950,4.3,3,7
59940,45,Ao thun nam nu unisex PARIS 1996 Unisex,133200,73260,5,1,1
0,0,Quan lot nam dang Brief - Quan sip nam cao cap cotton min,100000,100000,1,2,3
0,0,Ao Dui Nam Coc Tay Co Tau Phong Cach Tre Trung Nam Tinh Chat Lieu Dui Nhe Thoang Mat,150000,150000,5,3,9
0,0,AO SWEATER IN CHU HAN VA BONG HOA,68900,68900,4.5,28,102
0,0,AO KHOAC HOODIE NAM NU MAU DEN TRANG UNISEX NAM NU SO 2 MAU,75000,75000,3,1,7
0,0,"Ao so mi nam dai tay dang om body , vai lua thai chong nhan tham hut mo hoi cao cap",78000,78000,5,1,1
0,0,Bo the thao nam chat vai thun lanh 4 chieu.,78000,78000,5,1,3
0,0,"Ao phong nam co be ngan tay PHOI VIEN, ao co be phoi vien chat lieu cotton thoang mat ",78000,78000,5,3,7
0,0,Bo 5 Quan Sip Tam Giac Nam Xuat Nhat (Mau Ngau Nhien),90000,90000,5,5,5
0,0,Quan Baggy jean nam ong rong TRR001 +Tang 1ao phong unisex bat ky tri an khach hang,219000,219000,1,1,5
0,0,Hop 5 quan lot nam boxer thun lanh cao cap chuan xuat Nhat,106520,106520,2.4,9,57
0,0,Combo 4 quan lot tam giac nam xuat Nhat loai co Lo thong hoi - thoang khi Mau Ngau Nhien Khong hop,57900,57900,3.9,10,44
0,0,"Quan jean, Baggy Tron nam SR-01 Ong Suong, Rong style han quoc 2021",149000,149000,3.5,4,7
0,0, Ao Thun Nam Co Tron,68000,68000,2,1,2
0,0,Ao thun nam nu form rong - Ao thun 3d nam big size - Ao phong nu danh cho nguoi beo,68000,68000,1,1,6
0,0,"Ao thun ba lo nam, Ao ba lo va tanktop",68000,68000,5,1,2
0,0,AO THUN CO TRON TSHIRT NU NAM UNISEX MAU XANH NGOC LOANG,55000,55000,5,1,1
49500,15,Ao Tennis nam Dunlop - DATES9091-1C,330000,280500,4.2,5,14
0,0,Ao thun nam the thao dep ma TT56 co tron dep tay dai phong cach Han Quoc form rong cho mua thu dong ,117000,117000,4.5,8,40
0,0,Quan Short Kaki Nam Thoi Trang Akuba | 905,379000,379000,5,1,2
0,0,Bo Quan Ao Nam Ao Thun Quan Jogger Bo Gau Phong Cach The Thao Thoi Trang Zenkonu TOP NAM 1000136 + QUAN NAM 1000069,89000,89000,2.8,4,21
0,0,"Ao Khoac Bomber Du Unisex Form Rong 2 Lop ULZZANG, AO KHOAC GIO BOMBER NAM NU CUC BAM, Ao Bomber CHAT LIEU DU 2 LOP CHONG THAM NUOC, Ao khoac bomber bong chay nam nu",96000,96000,3.5,2,14
59000,20,Ao Nam Thu Dong NARSIS D7087,295000,236000,4.7,3,17
40000,20,"Ao so mi dui nam coc tay co tru 4 khuy phoi tui nguc LAHstore, chat dui mem mat, thich hop mua he, thoi trang tre, phong cach Han Quoc",204000,164000,4.5,19,40
0,0,COMBO 4 Quan lot nam chat cotton cao cap ke ngang- Quan sip nam,168900,168900,4.7,6,24
0,0,Ao khoac Hoodie Unisex ASALA (FEAR) - Freesize,39000,39000,4.7,9,36
61000,23,Bo 5 Quan lot nam dui Boxer cao cap thoang mat Pigofashion QLPG03 ( mau ngau nhien),260000,199000,4.5,11,137
93210,39,Ao Thun Nam Tay Lo Unisex co Tron chat lieu vai cotton mau den form rong in chu GRAVITY phong cach doc chat Trumunisex,239000,145790,5,11,33
0,0,Do Lam Di Chua # Lanh Tu Nam #Do Bo #Quan Ao Nam,155000,155000,5,1,2
0,0,Quan Jogger Nam Nu 3 Soc Form Ong Rong De Xuong Hoac Rut Day Bo Gau Vai Min Nang Dong Tre Trung,59000,59000,5,1,8
133000,50,Ao thun nam GUMAC ATNB669 in cay dua,265000,132000,4.8,6,19
0,0,Quan lot nam boxer dui lua sua cao cap BIG SIZE SIZE LON (5xl den 7xl) quan lot nam quan sip nam 65 den 120 kg,28000,28000,4.5,2,28
0,0,Ao Khoac Da Nam Ao Da Dang Ngan Lot Bong Sans07 Sans Shop,649000,649000,5,1,4
0,0,Quan ni lot long nam,0,100000,3,4,
0,0,Ao Thun Ba Lo Nam Rong Nach Tap Gym The Thao Tanktop Dep,59000,59000,4.5,2,14
14700,15,Quan lot nam xam xanh Khatoco Q4M098R0-VNMA033-2301-T,98000,83300,5,1,8
140000,56,"AO KHOAC GIO, AO GIO UNI CHONG NUOC, CHONG GIO",250000,110000,4.8,15,23
0,0,Ao Thun Nam In  CB Sea Collection,279000,279000,4,1,3
47000,19,Ao Thun T-Shirt Nam Jockey Chat Lieu Visco Mau Trang Mem Mai Tham Hut - J1149,245000,198000,5,1,5
47000,19,Ao Thun T-Shirt Nam Jockey Chat Lieu Visco Mem Mai Tham Hut - J1149,245000,198000,5,2,5
81590,41,Ao Thun Nam Tay Lo Unisex co Tron chat lieu vai cotton mau den form rong in chu Japan 3 phong cach doc chat TheNgaustyle,199000,117410,4.7,27,58
0,0,ao khoac kimono doi trinh sat trong ATTACK ON TITAN phong cach Nhat Ban,167000,167000,5,1,2
0,0,"ao ATTACK ON TITAN, ao hoodie doi trinh sat trong ATTACK ON TITAN phan quang",167700,167700,5,1,4
0,0,"Quàn Jean, Quan Bo Nam kiẻu phong cách han quoc hot trend 2021 msa28",130000,130000,4.8,4,13
0,0,"Ao Lien Quan phan quang, ao hoodie Lien Quan Mobile phan quang",143000,143000,5,1,2
0,0,Ao khoac jean Nam phoi ni sang trong va manh me cuon hut TRA209A,146000,146000,3.8,13,34
0,0,Ao khoac jeans nam hoodie AB05,129000,129000,5,2,6
0,0,AO SO MI CAP DOI NAM NU LOVE YOU HOT TREND XU HUONG TINH YEU HAN QUOC,70000,70000,4.5,36,88
0,0,Quan Bo Nam Trang Tron Chat Co Gian JEANTRANG98 (Jean Trang),125000,125000,5,3,34
0,0,"Ao so mi nam Xanh Reu khong nhan, So mi nam tron dang om",77000,77000,3.7,13,29
0,0,Ao so mi nam tay dai 4YOUNG vai lua cao cap KHONG NHAN SM1 - Den - L,74000,74000,5,1,276
0,0,Quan Jean Nam Slimfit S5679,139000,139000,4.1,11,40
0,0,Ao Minecraft Kiem Diamond ,59000,59000,5,1,8
75000,44,"(ANH THAT) AO SWEATER BONG CHAY FORM RONG UNISEX THIET KE DU SIZE CHO CA NAM VA NU, AO HOODIE CHUI DAU ULZZANG PHOI VIEN, Ao Ni Vien Co Tim So 26 Nguoc Chat Ni Ngoai Day Min",170000,95000,5,1,6
0,0,Quan ngo nam 5 mau sieu mat,64000,64000,4.7,18,40
150000,50,Ao Nam Vai Ni Bong Cao Cap Kieu Dang Tre Thoi Trang Thuong Hieu VICERO,300000,150000,4.7,6,16
274500,50, Ao so mi nam Novelty ngan tay 171398N vat ngang ,549000,274500,5,1,
0,0,"Ao Khoac Cap Nam Nu Chong Nang Di Mua Nhe, Ao Khoac Nam, Ao KHoac Chong Nang ",175000,175000,4,4,9
0,0,Quan tay au nam kieu theu logo xin xo mau moi nhat tai Julido Store BZ05,199000,199000,4.7,22,37
0,0,"Ao so mi ke soc thoi trang nam, size ao tu 50-75 kg ,ao so mi nam cao cap phong cach nam tinh 3 mau, dang ao om nhe tre trung, chat vai tho day dan mem min, khong bi bai xu",135000,135000,4,5,12
0,0,Quan Dui Nam Lung Thun Ban Rong - Mau Basic,55000,55000,0,0,2
116000,59,"Ao thun nam tron theu tim GUMAC mau xanh freesize, ngan tay cao cap thiet ke basic nang dong, tre trung ABB141",195000,79000,4.8,41,91
0,0,"Quan Jean Nam Vovesa Ba Mau Moi, Dang Om Tre Trung, Nam Tinh",99000,99000,5,1,1
0,0,Ao giu nhiet nam the thao dai tay nhieu mau,29000,29000,1,1,2
0,0,Ao khoac Bomber Varsity jacket The Bad God Beloved,675000,675000,5,2,3
0,0,Ao khoac bomber The Bad God Ruflled Embroidery,675000,675000,5,1,1
0,0,Ao khoac Bomber The Bad God Skullcap,750000,750000,5,1,
0,0,"Ao hoodie, ao sweater tron nam nu",117900,117900,4.5,5,16
0,0,Quan Lot Nam 5THEWAY Trunk Den aka 5THEWAY TRUNK UNDERWEAR in BLACK,150000,150000,4.8,5,18
200000,57,Ao So Mi Nam Hoa Tiet Thuong Hieu Thoi Trang Nam VICERO,350000,150000,4.1,20,42
223000,45,Ao Thun Nam Co Co Polo Cao Cap AKUBA | 01J623,499000,276000,5,3,15
0,0,"Quan Baggy Nhung Tam Nam ROUGH Outfit Phong Cach Han Quoc, Tre Trung, Ca Tinh",195000,195000,3.7,17,38
55000,50,Ao Thun Phan Quang Unisex Moi Ve Sieu Dep 40-67kg,110000,55000,5,3,17
11000,44,"Quan lot nam | quan lot nam lung thai cotton cao cap , lung cao 4cm , tham hut mo hoi tot , mang lai cam giac de chiu khi mac",25000,14000,5,23,116
0,0,Quan Thun Dai Thoi Trang Nam Akuba | 010395,289000,289000,5,7,18
0,0,Hop 3 quan lot 5D nam cao cap 3A-Quan lot nam boxer khang khuan cao cap,51000,51000,0,0,
0,0,Quan dai thun jogger nam bo lung thun Phuc An 1042,91000,91000,4.1,25,154
0,0,(Ao hoodie Vato9's) Ao hoodie Its real,319000,319000,5,1,2
0,0,Ao So Mi Nam Phoi Chu Lich Lam Thoi Trang Cao Cap NT1,99000,99000,4.6,54,113
0,0,Quan lot nam boxer ren luoi thoang mat - A064,95000,95000,4.2,5,18
0,0,Ao khoac bo nam trung nien dang co dien,195000,195000,4.8,9,29
0,0,Quan ngo bo giay nam ong suong,79000,79000,2.3,4,8
0,0,Ao So Mi Nam Dai Tay Dang Om Nhe - Thoi Trang Nam Hien Dai AD00001,132000,132000,4.5,31,291
59000,50,Ao thun nam nu unisex tay lo phong form rong teen co tron oversize cotton gia re basic den trang tee pull YOUNG BOY,118000,59000,5,4,17
99000,50,Ao hoodie nam nu unisex cap doi sweater local brand han quoc cute khoac zip choang cardigan chong nang GOGEROUS,198000,99000,4,3,5
99000,50,Ao hoodie ni ngoai ulzzang cap doi unisex nam nu sweater local brand khoac zip choang cardigan chong nang GAU NHOI BONG,198000,99000,5,1,2
99000,50,Ao hoodie nam nu unisex BOUNCE nhieu mau sac chat ni ngoai day dep form rong thoai mai- SamMy96 Shop,198000,99000,5,1,
59000,50,Ao phong oversize form rong tay lo oversize thun nam unisex co tron streetwear gia re han quoc COUPLE,118000,59000,5,2,2
59000,50,Ao thun nam nu unisex form rong tay lo phong teen co tron oversize cotton gia re basic den trang tee pull SPECIAL,118000,59000,5,1,3
0,0,AO KHOAC NAM LOT LONG CUU SIEU PHAM AO KHOAC MUA DONG PL08,160000,160000,1.5,2,3
99000,50,Ao hoodie unisex nam nu cap doi sweater local brand han quoc cute khoac zip choang cardigan chong nang DONT ,198000,99000,3,2,6
0,0,Set 5 Quan Sip Nam Xuat Nhat Thong Hoi Co Gian 4 Chieu Sieu Thoang Chat Sin Mau Ngau Nhien,78000,78000,0,0,4
0,0,Ao Mang To Dang Sieu Dai Ao Khoac Da Sans10 Sans Shop,990000,990000,5,2,8
131000,44,"Ao So Mi Dui Nam TSIMPLE, Ao Dui Nam Ngan Tay Co Tau, Chat Dui cao cap Nhieu mau ",300000,169000,4,4,9
30000,10,Ao giu nhiet nam Smart Heat giu am sieu nhe thoang khi thuong hieu Coolmate,289000,259000,5,3,22
0,0,Quan dai kaki nam NS031,230000,230000,0,0,1
0,0,Quan tay au nam dang om vai co gian nhe ben dep phong cach Han Quoc - Ghi Nhat - 32,82000,82000,1,1,
0,0,Quan Tay Au Nam Cong So Cao Phong Cach Han Quoc,99000,99000,4.5,14,32
0,0,"COMBO 5 quan short nam xuat khau, size lon tu 45-80kg, nhieu tone mau lua chon, chat lieu cotton thoang mat.",159000,159000,3.9,15,44
0,0,Ao thun nam co tim ngan tay dep nhieu mau du size ( co size lon cho nguoi 100 kg ),79000,79000,5,3,8
0,0,Viettien - Ao so mi cong so nam ngan tay mau trang vat bau regular,290000,290000,5,2,11
0,0,Ao Mang To Nam Chat Kaki Dang Ngan Ao Khoac Kaki Nam Dang Ngan Sans12 Sans Shop,599000,599000,5,5,14
0,0,QUAN JEAN NAM TRANG BASIC FORM SKINNY FIT CHAN MR SMILE 99 SHOP,200000,200000,5,1,1
34000,43,Ao Thun Nam In Chu Travel Everest AoKNAM12 (Trang),79000,45000,4.1,74,1309
0,0,"Ao khoac du , ao khoac gio , ao khoac unisex , ao khoac du bomber",93000,93000,4,1,1
0,0,Quan Bo Nam Den Rach Goi RACHGOI97 (Rach Goi),99000,99000,4.3,12,41
0,0,Ao Thun Tay Lo Unisex SAIGON VINTAGE 100% Cotton - HADES BRAND CHINH HANG,380000,380000,5,1,7
0,0,Ao Khoac Chong Nang Unisex Cao Cap - A2114,125000,125000,5,2,29
58000,36,QUAN DON MONG NAM QSHOP QN29,160000,102000,4.3,6,30
9790,11,Quan lot nam Relax RLU016 dang Brief,89000,79210,4.6,21,68
0,0, QUAN LOT NAM DAY NANG MONG COTTON HIEU BOX (HINH THAT),89000,89000,4.8,9,27
135000,45,Bo Mac Nha Nam Kieu Dang Hien Dai Phoi Mau Thoi Trang ZERO,300000,165000,3.7,3,12
0,0,"Quan Short Nhung Tam Nam Nu ROUGH Form Unisex 5 Mau Tre Trung, Ca Tinh",130000,130000,0,0,23
0,0,Ao so mi nam nu tay phoi vien mau moi sieu hot,85000,85000,5,1,1
0,0,Ao Phong Polo Nam YODY Pique Mat Chim Phoi Ke Kieu Dang Tre Trung Thoang Mat - APM3639,299000,299000,5,9,22
0,0,OWEN - Ao Polo nam Owen co dan thoang mat APV22338,485000,485000,5,1,
0,0,"Quan Kaki Nam Tron Chat Kaki Day Dan, Co Gian ROUGH OUTFIT",195000,195000,4.3,55,164
0,0,Ao so mi Nam Nu Unisex tay lo vai lua in hoa tiet (Face) co be - kieu ao tay ngan form rong Freesize,139000,139000,5,2,2
0,0,Ao thun Undertale Sans mau moi | Ao Sans Undertale cho be trai | be gai dep S07 | Ao Chat Store,129600,129600,4.5,2,3
0,0,Bo ba lo vai thun lanh co gian ,72000,72000,4.2,11,28
161000,47,Quan kaki ong suong THE 1992 phong cach cong so,340000,179000,5,5,20
0,0,AO CHONG NANG NAM THONG HOI,58900,58900,4.5,10,45
0,0,Ao khoac jeans rach nam bo sang AJ05,165000,165000,4.5,15,43
0,0,Quan Lot Nam Combo 5 quan sip nam Munafie cao cap kem tui zip,67629,67629,0,0,
0,0,Ao Polo Unisex Nam Co Vien,99000,99000,4,1,2
0,0,Quan lot boxer nam thiet ke tui Kangaroo kep den - Hunk Ultimate Pouch Trunk,145000,145000,4.8,6,19
0,0,"Ao Thun Nam Phan Quang CSCD - Cuoc Song Co Don, Ao Uninsex, Tay Ngan, Co Tron, Co Ao Thun Size Lon 2XL, 3XL, 4XL, XXL, XXXL, XXXXL",59000,59000,4.7,3,9
0,0,Ao Thun Thoi Trang Five The Way  Phan Quang 7 Mau,88000,88000,4.8,17,39
0,0, Bo dui nam KC chat mem dep mac mat nhu khong!!,173000,173000,4.3,11,25
0,0,Quan Au nam mau Xanh Bo Doi,99000,99000,5,1,5
26000,10,Ao Thun Nam Co Tron Owen Ngan Tay Bodyfit TSN90748,260000,234000,5,1,
16000,7,Combo 3 Quan Lot Nam Freeman 6042-CB3,225000,209000,4.6,14,66
26000,12,Combo 3 Quan Lot Boxer Nam Freeman 6520-CB3,225000,199000,4.3,6,101
0,0,Combo 3 Quan Lot Nam JME JM532,129000,129000,3.8,16,584
0,0,Ao so mi caro phoi non Unisex,125000,125000,4.5,5,48
0,0,Combo 2 quan short ni da ca 2 tui va lung thun day rut QC.02 Chat lieu ni mem mai duong may tinh te thiet ke hop thoi trang – Nhieu mau ( Tang 1 khau trang ),219000,219000,4,1,1
0,0,"Ao Thun Nam Ba Lo Cotton Sat Nach, Tank-Top Tron Basic Form Rong, Tap Gym Co Tron Co Dan Cao Cap Big Sport",135000,135000,4.6,57,209
0,0,Ao thun nam unisex phong rong hoa tiet sieu hot (UX-941-11),49000,49000,4.5,5,6
0,0,AO BA LO NAM PHOI VIEN COTTON CO GIAN TOT,139000,139000,3.9,7,13
0,0,Ao Khoac Du Nam Chong Nang ke soc trang tren tay ao mau moi MS7,195000,195000,4,1,2
0,0,Quan kaki nam tui hop cao cap_Tang moc khoa,319000,319000,4.1,22,46
81000,32,Áo khoác dù nam Hahaman dáu nón 2 lóp lót nỉ sành cao cáp AKD46,250000,169000,4.5,13,31
0,0,Quan Lot Det Kim Munafie 4529 Sip Nam Tam Giac Chat Luong Chuan Dep Sieu Co Gian Nam Tinh,21000,21000,5,1,5
0,0,Bo dui nam dai quan ong xuong,184000,184000,4.5,19,61
0,0,Quan Jean Nam Rach Nhieu Vai Jean THun Co Gian Nhe,189000,189000,1,1,1
0,0,AO KHOAC JEAN NAM CO NON PHOI VIEN,219000,219000,5,1,3
0,0,Quan Tay Au Mau Den Ong Con Vai Gian,135000,135000,5,1,1
0,0,Ao Khoac Free Fire BooYah [ HANG MOI VE ] Mau Den Co Non Kieu Dang Hoodie Cuc Chat 2020,159000,159000,4.2,12,59
0,0,"AO LONG VU,  AO KHOAC LONG VU SIEU NHE, SIEU AM",254000,254000,2.3,9,33
111200,44,Quan short jean nam B9999 co dan kieu dan tre trung don gian theu hoa tiet Julido thoi trang han quoc,250200,139000,4.2,19,37
0,0,Ao Tay Lo Unisex Phan Quang Form Rong Vai Min Du size - Con Qua,51000,51000,5,1,
0,0,Ao thun nam tay dai hang VNXK - dep me ly,125000,125000,5,2,3
0,0,quan short kaki nam(lung thun),55000,55000,4,1,2
0,0,Quan Jean Nam Jogger ca tinh A4,215000,215000,2.3,3,4
0,0,T-SHIRT BUI #24 AO THUN UNISEX - COOL BEACH,99000,99000,5,2,3
0,0,Ao Thun Polo Nam Nu co be hinh vai Ca Sau Cotton 4 Chieu,260000,260000,4,1,1
0,0,Quan lot tam giac Nam - TL06,95000,95000,4.7,3,8
0,0,Quan Kaki Tui Hop Nam,279000,279000,5,6,11
0,0,Quan short thun UNISEX Quan short nam nu QS19,69000,69000,5,10,30
0,0,"Quan sooc dui nam chat dui mem mat, quan short lung the thao chuan form cap chun day rut 5 mau",65000,65000,3.9,22,71
0,0,Ao Thun Tron Nam - Nu Unisex,39999,39999,4,4,11
0,0,"Quan Short Dui Nhung Tam Form rong Unisex Nam Nu Chat Mat Me, 3 Mau Tre Trung ",98020,98020,3,1,2
0,0,Ao thun Missout Moon universe unisex - missout streetwear local brand over ten lua (Den/Trang),135000,135000,5,1,2
0,0,Combo 2 Quan Ngu Nam Cotton Dmax ,198000,198000,5,1,1
0,0,Bo quan ao khoac gio nam trung nien trung tuoi si sll ANH THAT,349200,349200,5,1,1
50000,22,"Ao so mi dui nam co tau tui lat, thoi trang xuan he 2021",229000,179000,5,1,4
0,0,Ao Hoodie co mu Nam Beverly Hills Polo Club Regularfit Cotton Navy HMRLS20V143,1250000,1250000,4,1,3
0,0,Ao So Mi Nam Co tau dai tay mau den,142800,142800,4.5,2,5
50000,25,Ao khoac du nam GABOFASHION 2 lop chong nuoc cao cap co tui trong AKD233,199000,149000,5,1,1
0,0,Ao khoac Jean Hang Quang Chau - Jacket Jean for men Mau Moi 2020,350000,350000,5,1,3
0,0,"SET BO THUN HE NAM,THIET KE SIEU NGAU,CHAT LIEU VAI THOANG MAT THOI TRANG LANO STORE 99",79000,79000,4,1,2
0,0,Ao So Mi Nam Han Quoc Phoi Tay Cuc Dep,145000,145000,3,2,2
0,0,Quan Kaki Nam tui hop thoi trang linh (den),359400,359400,5,4,6
0,0,AO KHOAC NI NAM KHONG NON,219000,219000,1,1,1
40000,10,OWEN - Ao so mi trang coc tay dang REGULAR (vat tom) soi Soi ma AR22752N2,400000,360000,5,1,
35000,25,Ao khoac nam kaki 2 lop co non cao cap AKK015,140000,105000,4,1,2
0,0,Quan KaKi Tui Hop Phong Cach Linh Thoi Trang Nam Cao Cap TH02,339000,339000,5,1,2
0,0,Quan tay au nam vai day co gian khong bai mau ong con dang Han Quoc,82620,82620,4.5,2,4
0,0,"Ao ni Hoodie Drew BÚT CHÌ , Ao hoodie nam nu ni bong cotton",179000,179000,1,1,1
28000,50,"Ao lot nam 100% cotton trang LEDATEX sieu re, sieu dep",56000,28000,0,0,
0,0,"Ao thun Nam Nu Khong co GAU TRUC CIMT-0016 mau moi cuc dep, co size be cho tre em / ao thun Anime Manga Unisex Nam Nu, ao phong thiet ke co tron basic coc tay thoang mat",39999,39999,3,2,7
0,0,"AO PHONG UNISEX NAM NU GAU - Ao chat cotton day dan, khong giao, phai mau, hinh in dep - November",79650,79650,5,1,1
0,0,"Ao Gio Lot Cotton Vai Van Gao Cao cap Pmax Nam Nu, 2 Lop, Mu Thao Roi, Chong Nuoc, Chong Gio, Chong Nang, Phom Tre Trung",259000,259000,5,10,12
50000,42,QUAN NGU FEZZIO THUN COTTON 4 CHIEU,119000,69000,4.6,5,14
0,0,"Ao Gio Lot Cotton Vai Van Gao Cao cap Pmax Nam Nu, 2 Lop, Mu Thao Roi, Chong Nuoc, Chong Gio, Chong Nang, Phom Tre Trung",259000,259000,5,12,15
0,0,Quan sip tam giac nam - 0601,109000,109000,4,2,2
0,0,Ao Thun Tron Nam - Nu Unisex,45000,45000,4.7,6,23
0,0,Ao thun in hinh sieu xinh dang rong ,77430,77430,5,1,1
0,0,Ao khoac du BOMBER Nam Nu Unisex In Chu Noi 2 lop ,89000,89000,2,1,2
0,0,"Ao Gile Blazer Unisex, Ao Vest Ghi Le Khoac He Nam Nu, Khong Tay Form Rong GL01 Phong Cach Han Quoc MR HERO",199000,199000,1,1,3
0,0,Quan Jean Tron Nam Phong Cach,209000,209000,5,1,2
0,0,quan sot thun vai co gian cao cap,89000,89000,5,1,1
0,0,Ao len nam hoa tiet Quang Chau cao cap,250000,250000,1,1,1
0,0,Do bo the thao nam cao cap vai thun lanh sieu co dan hang chuan shop Phuongnamshop20 kvb28,81900,81900,5,1,2
0,0,Quan kaki nam tui hop_ Tang that lung vai va Moc deo khoa sang trong,379000,379000,4.6,7,13
0,0,DEAL SOC Ao thun One Piece - Luffy truy na mau trang cuc dep,148000,148000,4.5,2,4
0,0,Quan Short Hoat hinh Vit Perry,330000,330000,5,1,2
110000,39,AO THUN CO TRON COTTON MAT NHE SLIMFIT FEZZIO CHINH HANG ,279000,169000,2,1,3
0,0,Bo dua dua chat kate dui coc,45000,45000,5,1,2
0,0,"Ao ni doi sweater nam nu, ao cap cute - ao doi thu dong cute",123380,123380,4.5,2,6
0,0,BO QUAN AO NAM LINH RAN RI NGAN,259000,259000,4,1,11
0,0,Quan lot nam thun lanh pha lua Lung bang vua vai dep (Dang BODY) RM 1x602,36000,36000,5,1,10
0,0,"Ao Thun Nam Phan Quang In CO HAI QUAN, anime ONE PIECE , ao chat, di dem, di phuot bao ngau, nhin da mat",60000,60000,3.5,4,10
0,0,"Quan Lot Nam Khong Duong May Mong Nhe Thoang Mat Chong Han Hoa Tiet Thoi Trang, Quan Sip Tam Giac K024 - Cu,L",69000,69000,5,1,39
82000,32,COMBO 2 QUAN SHORT KATE COTTON FEZZIO N05 NEO ,258000,176000,5,4,6
0,0,Ao Luffy Ao Naruto |2 Ao in hinh One Piece Naruto dep sieu ngau gia sieu re nhat vinh bac bo,89000,89000,5,1,
0,0,"Ao Thun Nam Phan Quang Lo Phan Ung Ho Quang Iron man, Avenger Movie, Ao Uninsex, Size Rong,  Size Lon, Size Nho, Tay Ngan, Co Tron, Ao Nam Size Lon, Co Ao Thun Size 2XL, 3XL, 4XL, XXL, XXXL, XXXXL",60000,60000,4.5,17,30
159200,44,"Quan Bo Nam cao cap thuong hieu Chandi, chat jean co dan mau moi 2021 MA81",358200,199000,4.5,8,16
0,0,"Quan lot dui nam boxer Duc lua cao cap, quan sip nam co gian, mat mau dep - Minhstore",39000,39000,4,2,2
0,0,"Bo Quan Ao Nam The Thao Nang Dong Mau Den Kieu Dang Thoi Trang Chat Lieu Mem Mai kha nang thoat am rat tot, mac rat mat va chong bam bui -Icon shop BST051",129000,129000,1,1,
71000,44,Combo 5 Quan Sip dui nam cotton SIEU MAT,160000,89000,5,2,5
0,0,Quan Lot Nam chu A vai Det Lua khang khuan cao cap xuat Nhat co dan 4 chieu cuc chuan 50-70kg - MINHSTORE,23200,23200,5,1,4
0,0,Ao Khoac KaKi Nam Han Quoc Hai Hop Hoa Tiet Sieu Dep Chong Nang Chong Tia UV,140000,140000,3.6,7,43
0,0,Quan Short Nam Chat Dui - Quan Dui Nam Chat Thoang Mat Dang Tre Trung T36,122000,122000,4,3,5
0,0,Quan Short Jean Nam Cao Cap Co Gian - Den - 31,179000,179000,5,1,5
0,0,Bo Quan Ao Ran Ri Linh My US ARMY Tui Hop Chien Thuat [Tang That Lung],445000,445000,3.9,28,177
50000,24,"Ao so mi nam vat ngang Amazing mau trang, dong phuc hoc sinh cac cap, vai KT silk mem mat, form slim fit, than ao gon dep, size tu 40 den 100kg",209000,159000,5,1,1
0,0,Ao So Mi Mam Dai Tay Han Quoc Dang Om So Co Be Vai Lua Thai Chong Nhan Chong Xu,99000,99000,3.5,2,19
110000,44,Quan jogger nam mamc phong cach duong pho,249000,139000,4.6,7,18
0,0,Ao thun polo nam soc ngang ca sau co co be Nexx & Dee trung nien vai thun lanh cao cap ND001,149000,149000,5,1,2
0,0,Ao thun polo nam co co be hoa tiet cham bi vai ca sau mat me tre trung ND06,139000,139000,4.6,8,10
115000,46,Ao khoac du Hahaman da quang 2 lop cao cap co dung AKD01003,250000,135000,5,10,2
135000,48,Combo 2 Quan shorts the thao nam dang sot sport dui chat thun lanh 4 chieu cao cap phu hop tap gym hay mac nha mau trang va den DUI-P101 - tang 1 khau trang chong nang ,284000,149000,4,36,159
0,0,Ao thun polo nam co co be phoi co soc ngang vai vai ca sau cao cap ND07,149000,149000,4.5,31,55
0,0,Ao Thun Nam Tay Dai Dang Om Vai Cotton Mat,149000,149000,5,3,13
0,0,AO KHOAC PHAO NAM 3 LOP TRAN LONG VU SIEU NHE SIEU AM AP KN07,150000,150000,2.3,3,5
0,0,Ao thun polo nam ca sau CV the thao cham bi hoa tiet soc ngang co co be trung nien cao cap PL31,149000,149000,4,1,4
0,0,Ao so mi nam FLANNEL ke caro Unisex phong cach duong pho ArcticHunter,139000,139000,3,2,5
103200,44,"Ao Thun Nam Co Tron Tay Ngan In Hoa Tiet Cao Cap, Ao Thun Nam Phong Tron Basic Unisex, Ao Thun Nam The Thao Tre Trung Mac Thoang Mat Tham Hut Mo Hoi Tot Thuong Hieu Chandi Ma NH1",232200,129000,5,8,35
0,0,BO DO NI COTTON DAI NAM THU DONG,269000,269000,5,1,3
143200,44,Ao Khoac Nam chat kaki 2 lop xin xo Thuong Hieu Chandi mau moi theo xu huong thoi trang 2021 NT306,322200,179000,4.7,21,64
59000,10,OWEN - Áo so mi dai tay Owen Slimfit chat soi tre ke ca ro mau nau 61012,590000,531000,5,1,2
127200,44,"Ao thun nam dai tay Chandi, Chat thun cotton xin bo tay va hong mau thu dong MA22",286200,159000,4.6,9,11
60000,27,"Ao so mi hoa tiet Amazing cho nam, chat vai mem mat, dang rong, coc tay, vat ngang, co size cho nguoi 105kg",219000,159000,4,1,1
127200,44,"Ao Thun Nam Ngan Tay Thuong Hieu Chandi, Chat Thun Cotton Xin Mau Moi NH8",286200,159000,4.7,22,91
54000,49,"Combo 4 Quan Lot Nam Nhieu Lung Thun Lanh, Quan Sip Nam Tam Giac - Mau Ngau Nhien",110000,56000,5,1,1
0,0,AO KHOAC JEAN NAM SIEU HOT VAI SIEU DAY PHUONGNAMSHOP20 MKTB22,166000,166000,0,0,1
159200,44,"Quan Jean Nam dep dan dau xu huong Thuong Hieu Chandi , mau moi form dep ton dang khong qua om mau HD176",358200,199000,5,27,40
111200,44,"Do Bo The Thao Nam mau den co gian tot thuong hieu Chandi, Do Bo Mac Nha chat lieu thun cao cap mat me, tham hut mo hoi tot NT1907",250200,139000,5,23,27
5000,13,Quan dui nam the thao cotton QD024 (mau ngau nhien),39000,34000,4,1,2
0,0,Bo Quan Ao Linh My Thuy Quan Luc Chien,799000,799000,5,3,6
0,0,"Ao Thun Nam Polo Ngan Tay Co Co Form Rong Vai Khong Nhan, Thoang Mat Ao Polo Mau Den Cao Cap Big Sport",249000,249000,4.8,6,10
0,0,Quan jean nam ong dung rach MESSI SJM-549-17,560000,560000,4,1,2
0,0,AO KHOAC KAKI NAM PHONG CACNH,175000,175000,0,0,
0,0,Quan vai nam trung nien hang cty Tan Chi Binh+ ANH THAT,289000,289000,5,1,1
0,0,"Ao Polo Nam, Ao Thun Nam Cao Cap Chat Lieu Da Ca Sau, Hoa Tiet Soc Tay Thanh Lich - ac118 - Azila",180000,180000,4,1,
0,0,"Ao bao ve mau xanh, ngan tay co dai (Khong bao gom quan va phu kien: mu, ca vat, cau vai, tiet ve)",99000,99000,4,1,3
0,0,Ao thun co be vai ca sau cao cap ATN09,325000,325000,5,1,1
0,0,Ao len nam dai tay co tron cao cap phoi o vuong AL10 ,177990,177990,5,1,
110000,22,Ao khoac da lot long cao cap Gabo Fashion,499000,389000,3.5,2,2
0,0,Ao so mi nam caro BBR ngan tay du mau vai cotton xuat du (̀ ̣ ),169000,169000,5,1,
60000,27,"Ao so mi cham bi tay ngan cho nam thuong hieu Amazing, chat vai mem mat, dang rong, vat ngang, co size cho nguoi 105kg",219000,159000,4,1,2
0,0,Quan Ni lot long Nam sieu am chong choi dai han dang Jogger the thao chat day dan co dan tot,210000,210000,0,0,
0,0,"Ao So Mi Nam Kaki Dai Tay NF01 Thoi Trang TOP FASHION SHOP Chat vai mem, thoang mat",149000,149000,2,1,1
0,0,Ao Khoac Nam Kaki Jean Titishop AKN259,99000,99000,2.9,11,148
0,0,Quan Short Kaki Nam Loai Xin ,69000,69000,5,1,4
0,0,Ao khoac jean nam K135,240000,240000,2.7,3,7
0,0,Ao so mi viet tien dai tay mau kem,350000,350000,4,2,5
0,0,"Quan lot nam boxer ""Chuyen dong"" Hunk Active Cool tui Kangaroo dat theo chieu doc mau do phoi den",129000,129000,4.7,6,39
0,0,AO Khoac Du Nam Nu 2 Lop Hoa Tiet 3D Chong Nang Chong Tia UV (ak-703),79000,79000,4.8,8,17
0,0,AO KHOAC NHUNG NAM BOMBER UNISEX NHIEU MAU SAC SINH DONG MAU MOI NHAT HIEN NAY,150000,150000,5,1,
0,0,Quan lot tam giac Trunkini Hunk - su ket hop giua quan Boxer va Bikini,129000,129000,4.2,10,64
0,0,Quan short nam the thao big size the thao vai gio thoang mat Micado,50000,50000,5,1,2
0,0,Combo 2 Quan Lot Nam JM150,119000,119000,4.5,2,22
0,0,AO LUFFY SNAKE MAN GEAR 4 SIEU DEP OP113,79000,79000,5,1,2
0,0,Ao Khoac gile Nam Phong Cach Linh ARMY 100% cotton,329000,329000,3.8,5,22
0,0,Quan The Thao Nam Thoi Trang Tre Trung ONGTHUONG62 - Ong Thuong,80000,80000,0,0,
61000,27,"Combo 3 ao ba lo nam mem min sieu thoang mat, tham hut tot, co gian tot ABL01-1 PigoFashion",230000,169000,4.6,5,13
91000,41,Ao thun polo nam phoi bo doc dao Pigofashion AHT07 ( chon mau),220000,129000,4.5,19,313
91000,41,Ao thun polo nam ao phong nam vai cotton mem min phoi bo thoi trang doc dao TKAHT07 PigoFashion chon nhieu mau,220000,129000,4,2,3
61000,25,Ao thun nam ao polo ngan tay co co hoa tiet tren ao TKAHT28 PigoFashion nhieu mau chon lua,240000,179000,5,4,5
0,0,Ao khoac phao nam AN206,850000,850000,1,1,2
111200,44,"Do Bo The Thao Nam thuong hieu Chandi, Do Bo Mac Nha chat lieu thun cao cap mat me, tham hut mo hoi tot MS906",250200,139000,4,10,33
0,0,Ao Thun Ba Lo Nam Mãu 5,79000,79000,3,1,
39000,50,Ao thun dai tay co tim nam,78000,39000,1,3,9
0,0,Set do Haori nam Kimono Yunhe Jiuxiao phong cach Nhat Ban sieu chat BSK04,192500,192500,4.5,2,4
0,0, AO khoac ao hoodie Naruto Akatsuki cuc HOT khuyen mai khung gia re dep,152200,152200,5,1,5
0,0,Ao So Mi Coc Tay Co Tru Giau Khuy - Vai Dui,165000,165000,4.5,2,12
91000,20,Ao len gile Aligro ALENGL017,455000,364000,4,1,7
0,0,Ao khoac gio nam ( CO UP HINH THAT O CUOI ),85999,85999,5,1,3
79000,50,Ao thun SWE International Bang,158000,79000,5,1,5
0,0,"Bo 5 quan boxer nam thong hoi phoi cotton, quan sip dui nam ",78000,78000,3,1,2
0,0,Quan lot lot khe nam - do,49000,49000,4.8,4,29
0,0,Quan Tay Nam,159000,159000,4.3,14,26
0,0,Ao so mi dui kieu dang han quoc,119000,119000,4.5,8,24
0,0,Ao Len Nam Cao Co Form Om Bs53,350000,350000,3.6,5,16
0,0,Ao So Mi Nam Co Tau Mau Xam Tieu SM03,99000,99000,4.2,51,256
0,0,Ao So Mi Nam Tay Ngan Hoa Tiet The Shirts Studio Han Quoc TD42F2110PI,89000,89000,5,1,9
0,0,Ao so mi nam ke soc BBR,149000,149000,2.3,3,5
0,0,Ao Thun Phan Quang Whatever You Can Cotton 75%,195000,195000,5,1,1
0,0,"QUAN LANH NHAP KHAU ( quan lot nam, quan sip nam) cao cap",99000,99000,4.7,29,143
0,0,Combo 2 Quan Dui Nam Mac Nha CB1 - Mau Ngau Nhien,75000,75000,1,1,2
61000,27,Ao thun nam Polo co be PiGo chuan phong cach AB19 (Xanh da troi),230000,169000,4.5,11,74
0,0,Combo 5 Quan Sip Tam Giac Thong Hoi Xuat Nhat (Giao nhieu mau),99000,99000,3.9,8,79
0,0,Ao thun nam ca sau cao cap,139000,139000,0,0,
0,0,"Ao so mi nam dai tay cong so , mau trang tron lich lam",79000,79000,3.3,3,6
28000,14,Combo 3 Chiec Quan Lot Nam Tam Giac Cao Cap iBasic Brief VM021,207000,179000,4,7,126
90000,31,Ao so mi nam Amazing soc,289000,199000,3,1,5
0,0,AO SO MI NAM DAI TAY 2 DA KHONG NHAN,199000,199000,5,1,2
0,0,"{ANH CHUP THAT} Set doi nam nu quan lung phu hop cac cap doi, nhom ban dung lam dresscode trong cac buoi party mua he",340000,340000,5,2,3
0,0,Ao thun nam ngan tay EO,77000,77000,3,1,11
0,0,Ao thun nam Voga co tim ngan tay vai thun cotton bon chieu co dan.,129000,129000,4.1,9,80
0,0," ATIN70 Ao Thun Tay Lo In Connwins Form Rong Unisex Freesize Duoi 75kg, phong cach thoi trang cao cap",89000,89000,4,1,1
0,0,"Ao Thun Nam Motorcycle - Biker T-Shirt Den in TRIUMPH, TAM GIAC",390000,390000,5,2,2
0,0,Quan tay nam viet tien mau den co 1ly regular 1P4058,540000,540000,5,1,
0,0,Quan thun nam ma TT24 Quan short nam the thao dang lung tron dui ngan vai gio phong cach mua he,38900,38900,4.2,5,25
0,0,(SALE) Bo ao thun va non ket in logo youtube,154000,154000,5,1,3
0,0,"Ao Polo Nam, Ao Thun Nam Tay Lo Co Co, Chat Lieu da ca sau, Phong Cach The Thao, Full Mau, Full Size - AZILA - AC109",229000,229000,2,1,1
32500,33, quan short nam chat dui sieu thoáng mát,97500,65000,5,8,16
0,0,Combo 3 quan Lot nam XM- Quan sip xi nam thun lanh co gian moi(sieu sale),102700,102700,5,1,1
0,0,BO NI NAM DAI,155000,155000,3.5,6,12
0,0,Ao khoac du bomber 2 lop nam hoa tiet cuc dep,96000,96000,2,1,1
0,0,Quan lot nam trong suot N44,50000,50000,5,1,4
0,0,Ao thun Nam BigSize 100kg tro len ( 3XL 4XL 5XL 6XL 7XL ) in logo Garena M2270,144000,144000,4,1,2
0,0,Ao thun nam nu co co ( Co tru Polo ) mau den tron - Vai Ca sau Poligan Thai,115000,115000,4,1,1
0,0,Ao thun co be polo cao cap vai thun cotton sieu co dan hang chuan shop Phuongnamshop20 kve51,86400,86400,5,3,1
61000,36,Ao Ba Lo Tank Top The Thao Nam TSIMPLE Ver.02 Nhieu mau,170000,109000,5,2,5
0,0,Quan short jean nam ong suong trung nien QN501D,195000,195000,5,1,1
65000,43,Quan short jean nam xanh den vai dep Q393 Muidoi | quan nam | quan short nam - 30,150000,85000,0,0,228
0,0,Ao len nam co tron det kim,105000,105000,4.7,3,5
282500,50,OWEN - Áo so mi dai tay Owen Slimfit vải sọi tre mau hong nhat 68079 - Áo so mi nam,565000,282500,5,1,2
0,0,QUAN SHORT NAM CUC CHAT,200000,200000,4.6,12,24
134000,50,"QUAN TAY AU HAN QUOC OM CO GIAN, KO RA MAU KO BAI XU MAU DEN",270000,136000,0,0,
0,0,Quan Short Dui Nam Boxer Tap Gym Mac Ngu Super Body,120000,120000,3.8,8,76
0,0,Quan sot kaki Nam size 40-75kg,39000,39000,4.1,13,49
0,0,Ao So Mi Nam Ngan Tay Chu Nhat mau VK01 Thoi Trang Cao Cap PONIVA Thiet Ke Tre Trung Nang Dong,125000,125000,5,1,3
0,0,"Ao Ni HOODIE Drew house Chu gau, ao ni bong hoodie unisex nam nu cao cap",178000,178000,3.7,3,4
0,0,Quan Sip Duc Nam Cao Cap Nhat Ban,55000,55000,4.7,59,825
0,0,Quan Jean Nam Rach Goi Co Gian Tot,158000,158000,3,1,8
0,0,"Quan lot nam, quan sip nam [ COMBO 4 QUAN ]  quan lot boxer nam quyen ru phong cach han quoc SP-289",120000,120000,4,57,196
0,0,AO THUN NAM DAI TAY CAO CAP PHOI MAU,149000,149000,5,3,6
79200,44,"Ao Thun Nam Ngan Tay Thun The Thao Mat Min Thuong Hieu Chandi, Tham Hut Mo Hoi Mau Moi NH25",178200,99000,3.8,11,95
60000,25,"Ao so mi hoa tiet tay ngan cho nam, chat vai mem mat, dang rong, coc tay, vat ngang, co size 105kg, thuong hieu Amazing",239000,179000,4,1,1
0,0,Ao Khoac Thun Nam Couple TX MOK 1012,579000,579000,5,3,6
0,0,AO THUN NAM DREAMING,108000,108000,1,1,1
100000,24,"Quan tay nam cao cap Amazing, quan au khong ly, mau xam xanh va xam chi, hoa tiet van chim, form truyen thong",419000,319000,4.7,3,7
0,0,"Quan short nam, quan dui the thao nam phoi vien phong cach Han Quoc in logo nhieu mau",100000,100000,5,3,12
0,0,AO THUN NAM DAI TAY NI DA CA PHOI MAU CAO CAP ATD04,297700,297700,1,1,2
57500,10,OWEN - Quan au nam cong so dang SLIMFIT ma QS22419 ,575000,517500,5,1,3
81000,41,Ao so mi nam caro cao cap ngan tay Hahaman HM22 nhieu mau,200000,119000,5,2,6
0,0,Quan Jean Nam Chat Bo Cao Cap Quan Rin Nam Den Tron Phong Cach Co gian GH133,149480,149480,3,1,5
0,0,"[COMBO 5] Quan sip/ lot nam Boxer thun lanh, LUA CAO CAP khu mui va tham hut cao",140000,140000,3.8,4,8
144000,44,"Quan Short Jean Nam co dan kieu dang tre trung don gian Thuong Hieu Chandi, quan sot mau moi xu huong 2021 QSJN241",324000,180000,5,16,23
0,0,Quan Tay Au Mau Moi ️️ Quan  Au Nam Cao Cap Thoi Trang Han Quoc Co Gian Nhe Chuan Hang Shop To To Shop - QTA5,158000,158000,4,2,7
1000,1,QUAN SHORT NAM THUN 100 % COTTON FEZZIO CO TUI,85000,84000,5,3,17
0,0,"Ao khoac One Piece Luffy K09, Ao khoac hoodie Anime Manga One Piece Monkey D. Luffy Unisex Nam Nu",220000,220000,5,7,13
0,0,"Quan Short Nm Chat Jean King168 , Quan Short Jean Nam Cao Cap NT140",149400,149400,5,1,1
200000,44,"Ao So Mi Nam Trang Hoa Tiet Form Rong thuong hieu Julido Store, phong cach dam chat han quoc SM9999",450000,250000,5,9,16
159200,44,"Quan Jean Nam dep dan dau xu huong Thuong Hieu Chandi , mau moi form dep ton dang khong qua om mau MA79",358200,199000,5,37,127
0,0,Ao thun nam FEAER DENIM chat tham hut nhe vai cotton THUN BASIC mau be,149000,149000,5,1,2
57500,10,OWEN - Quan au nam cong so dang SLIMFIT ma QS22415 ,575000,517500,5,1,2
0,0,Ao so mi nam FEAER DENIM chat thoang khi nhe thoai mai vai lua MONOGRAM,289000,289000,5,1,1
0,0,"Ao thun nam phong tron Casual 1st co tron tay ngan coc, vai 100% cotton cao cap thoang mat, tham hut mo hoi, form ao tre trung thich hop di lam, di choi, dao pho, du lich, Made in Vietnam",250000,250000,4.7,3,5
0,0,AO SO MI NAM DAI TAY BODY KHONG NHAN,219000,219000,5,1,1
0,0,Ao khoac du 2 mat mem min thoang mat LAVIC-2015,249000,249000,3.8,4,10
0,0,so mi tay dai tron unisex,190000,190000,5,1,1
0,0,Ao khoac viet tien hai lop mau xanh den 6P5049,595000,595000,3,1,2
0,0,Combo 3 ao ba lo co vuong cotton loai 1 mem mat loai ao ba lo tap gym mat,79000,79000,0,0,
0,0,Ao khoac so mi han quoc unisex cho nam nu,190000,190000,4.5,2,11
0,0,Ao Khoac Da Nam 2 Tui nguc ca tinh va manh me,390000,390000,2.5,2,4
0,0,"Quan bo ong con nam rach goi soc trang cuc dep 2021, Quan jean nam mau xanh rach goi chay soc",129200,129200,5,1,5
40000,31,"Ao thun nam tay lo form rong Unisex in hinh QUID, chat lieu thun cotton mem mat, thoi trang tre, phong cach Han Quoc",128000,88000,4,32,100
40000,19,"Ao so mi nam form rong co 2 ve LAHstore, thoi trang tre, phong cach Han Quoc",209000,169000,4.5,30,76
71000,30,Ao thun polo ao phong nam ngan tay co co hoa tiet khoi TKAHT30 PigoFashion chon nhieu mau,240000,169000,5,1,1
0,0,"Ao Thun Nam Phan Quang In hinh PIKACHU , ao chat, di dem, di phuot bao ngau, nhin da mat",60000,60000,4.6,47,114
50000,23,"Quan jeans nam mai rach tre trung phong cach ca tinh, thoi trang phong cach Han Quoc",219000,169000,1,2,3
0,0,"Ao Khoac Kaki Han Quoc Cao Cap, Ao Khoac Thoi Trang 2 Lop Co Tui Trong",179000,179000,1,1,3
0,0,Ao chong nang nam chat lieu thong hoi kim cuong sieu mat lanh nhieu mau,69000,69000,4.8,6,6
0,0,"Ao ni - thoi trang cho phai manh, kieu dang dai tay (T41)",176000,176000,5,1,1
0,0,"Ao One Piece Luffy Timeskip T13 mau Den & Trang Moi, Ao thun Anime Manga One Piece Monkey D. Luffy co size be cho tre em 25-90kg Unisex phu hop cho nam + nu / TEESETT STORE",115000,115000,5,2,8
0,0,{SIEU PHAM MUA DONG} AO KHOAC NAM/AO KHOAC PHAO NAM TRAN BONG 3 LOP SIEU AM AP MUA DONG CO SIZE 3XL VINA 1HITSTORE,150000,150000,3,1,2
0,0,Ao Phong Nam ️️ Ao Thun Nam Tay Ngan Co Be Thoi Trang Cao Cap Mau Moi Hang VNXK To To Shop - ATNTT7,89000,89000,4.3,4,5
0,0,Combo 5 quan dui thun ngu nam ,219000,219000,3.7,3,5
0,0,"Ao One Piece Luffy ATT-06, Ao thun Anime Manga One Piece Monkey D. Luffy Unisex Nam Nu",32900,32900,4.8,9,22
0,0,"Ao thun Nam Nu Khong co ONEPIECE TRUONG TAU MU ROM MSOP-28 mau moi cuc dep, co size be cho tre em / ao thun Anime Manga Unisex Nam Nu, ao phong thiet ke co tron basic coc tay thoang mat",39999,39999,5,1,3
0,0,"Bo do doi nam nu mua he, chat vai cotton tu nhien thoang mat, tong mau xanh diu nhe, hoa tiet vui nhon dang yeu",340000,340000,4,2,6
0,0,Ao Thun Nam Everest AokNAM408 - Trang,226000,226000,3.5,2,86
0,0,Ao Thun Nam In Hinh AW Everest AokNAM401 - Do,195000,195000,3.8,4,17
0,0,Ao Thun Nam In Hinh USA Everest AokNAM402 (Trang),195000,195000,4.5,2,14
0,0,Ao Thun Nam In Hinh YouTube Everest AokNAM396 (Trang),195000,195000,4.1,39,499
0,0,Ao Thun Nam In Hinh YouTube Everest AokNAM396 (Trang),195000,195000,4.1,39,499
0,0,Ao Len Nam Co Lo Day Bs30,249000,249000,3.3,6,13
0,0,QUAN JOGGER KAKI NAM WILD SOUL PHOI PHAN QUANG,99000,99000,5,5,13
0,0,Ao thun nam tay dai co tron - ATTD2,85000,85000,3,2,5
34000,29,QUAN NGU NAM KATE FEZZIO 100% COTTON,119000,85000,3.9,13,42
91000,46,Ao so mi nam ngan tay mua he 2020 phien ban Han Quoc -ao ke o vuong gian di ,200000,109000,3.1,8,35
0,0,Combo 3 ao thun tron cao cap mau den,329000,329000,4.7,3,5
0,0,"COMBO 5 QUAN DUI NAM MAC NHA CHAT KAKI MEM, THOAI MAI (Giao mau ngau nhien) - CB5CLZTS009",130000,130000,4.5,2,4
0,0,AO BA LO THONG HOI CHO NAM,109000,109000,5,1,1
0,0,Ao Gile nam phong cach Han Quoc GL02,199000,199000,4.2,13,153
0,0,Ao so mi dui nam,149000,149000,3.3,6,30
0,0,Quan dui dai nam,149000,149000,4.5,14,32
0,0,Ao thun tay lo Nomac Unisex in hoa tiet doc la X SPACA AT0703/ Freesize/ Phu hop ca nam va nu.,58000,58000,5,17,25
0,0,"Quan sooc nam nu mac nha, quan dui unisex ong rong mau den, trang Yinxx QS56",79000,79000,5,2,6
0,0,Ao len nam dai tay co tim phong cach Han Quoc,300000,300000,0,0,
0,0,Ao len co tim dai tay nam thoi trang Han Quoc SAL212 Trang,279000,279000,0,0,
0,0,QUAN SHORT AU NAM - Den - 28,135000,135000,0,0,19
0,0,Ao thun nam co co tay ngan vai Thun Cotton 100% Mem min co gian thoang mat - Skymenfashion,65000,65000,4,1,3
0,0,"Ao Thun Nam_ Nu  Phan Quang In hinh BAD HABITS , ao chat, di dem, di phuot bao ngau, nhin da mat",60000,60000,4.3,11,27
61000,41,"Ao thun nam tay lo unisex in hoat hinh ArcticHunter, thoi trang phong cach duong pho",150000,89000,3.7,3,8
121000,50,Quan thun jogger theu chu SPUN ️ Nam nu unisex ️,240000,119000,5,2,3
117200,20,Quan khakhi dai nam Owen SlimFit-QK18270-BR,586000,468800,2,1,2
0,0,Quan sip lanh - Quan sip duc lua - Sip Nhat Ban,49000,49000,5,1,2
0,0,Ao GILE 2 soc vien mau TRANG/ DEN - Nam Nu Unisex,129000,129000,5,2,5
0,0,Ao Khoac Nam Bomber Da Lon Lot Gio Phong Cach Han Quoc Tre Trung Lich Su Chong Nuoc Nhe 23,299000,299000,5,2,2
50000,21,"Ao so mi dui nam dai tay co tru chui dau, chat vai dui mem mat, thoi trang phong cach Han",239000,189000,3.5,2,2
129500,50,QUAN SHORT NAM  FEZZIO CHINH HANG ,259000,129500,5,1,2
0,0,Viettien - Ao so mi nam ngan tay vat bau cham bi regular 1P0340,490000,490000,3,2,2
0,0,Quan dui nam chat kaki,60000,60000,5,1,7
0,0,"AO KHOAC KAKI NAM CUC CHAT PHONG CACH , SIEU XIN , CHAT , NGAU CHO ANH EM ",199000,199000,1,2,2
0,0,Quan Short Vit Vang Unisex - Quan short cartoon Vit hoat hinh,330000,330000,4,1,1
0,0,Ao Thun Tay Co Co Ke Soc Vai Thun Cotton 100% cao cap - ATN300,75000,75000,4,1,
0,0,AO THUN Resident Evil DEPSIEUSALE AO THUN IN HINH Resident Evil,129000,129000,4.5,2,2
0,0,AO THUN NAM DAI TAY DEP,149000,149000,5,1,1
0,0,"Quàn Jean, Quan Bo Nam kiẻu moi phong cách hot trend 2021 T&L store ms a1",137000,137000,3,4,7
0,0,quan jogger kaki nam,149000,149000,1,2,9
0,0,QUAN KAKI NAM TRON CO GIAN NHE,199000,199000,1,1,2
0,0,Quan ngu Nam thun luoi sieu mong - A028,140000,140000,4.5,6,41
0,0,Ao Khoac Kaki Jean Nam nhieu mau Cuc Chat - Hot New 2021,35200,35200,5,1,2
0,0,"Ao Thun Nam Co Be POLO Tay Ngan Vai Dep (Hinh That),Ao thun in hinh Dog thanh lịch,áo thun nam cỏ bẻ ,Soha Clothing",190000,190000,1,1,1
0,0,Ao so mi nam dai tay TMINA in hoa tiet chat vai lua khong nhan cao cap - SMD02,199000,199000,4,1,1
0,0,"Combo Ao Khoac ni, Khan Bit Mat Alan Walker",180000,180000,4.6,10,55
81000,45,"Ao thun nam co tron HAHAMAN vai Cotton co gian,day dan cao cap CT06005",180000,99000,5,1,2
0,0,"Ao So Mi Nam Ngan Tay Mau TNFS Thoi Trang Cao Cap PONIVA Phong Cach Han Quoc Tre Trung, Lich Lam",125000,125000,5,3,7
56000,10,OWEN - Ao so mi coc tay soi Tre AR22573NT,560000,504000,5,1,2
0,0,QUAN LOT NAM 8001,47500,47500,5,1,1
0,0,quan short tay au cao cap V&N,79000,79000,5,1,3
0,0,Quan Jean Nam Rach Kieu - jean vai day dan,299000,299000,5,1,1
